text	intent
告訴我從費城飛往達拉斯的是停在亞特蘭大的航班	機票
我需要從巴爾的摩飛往達拉斯星期二晚上	飛行
從紐瓦克飛往克里夫蘭每天下午5點航班	飛行
給我的波士頓和丹佛之間的航班	飛行
讓我從舊金山到波士頓費城或巴爾的摩的所有航班	飛行
顯示波士頓和丹佛之間的航班	飛行
什麼是週三的最新航班會從亞特蘭大到華盛頓特區	飛行
什麼是從巴爾的摩到舊金山週五八月三十最便宜的機票	飛行
I'd像從丹佛一張票，亞特蘭大與匹茲堡停留這是可能	機票
我想舊金山美國航空公司航班從巴爾的摩在丹佛停止	機票
什麼是車費去的一種方式在十一月十七從丹佛飛往奧克蘭	飛行
有沒有在美國聯合航空公司從波士頓到丹佛航班	機票
告訴我從費城到亞特蘭大晚上航班	飛行
給我看在費城地面上週一早上交通	飛行
我想從多倫多到聖地亞哥的美國飛機在丹佛停留請	飛行
什麼才是從奧克蘭最便宜的單程飛行到波士頓	飛行
我想從巴爾的摩飛往達拉斯往返	飛行
告訴我，從亞特蘭大到匹茲堡的航班單程	飛行
上週日從坦帕飛往夏洛特的航班	飛行
找到從達拉斯往返航班飛往匹茲堡的行程安排	飛行
什麼是最便宜的單程票價從波士頓飛往匹茲堡	飛行
什麼是在當天的最新航班從巴爾的摩在波士頓抵達	機票
什麼是從丹佛飛往匹茲堡最便宜的航班	飛行
告訴我從丹佛飛往匹茲堡和亞特蘭大的航班	飛行
確實TWA必須從印第安納波利斯到休斯敦飛行抵達上午11時	飛行
我需要知道什麼航班離開亞特蘭大在週日晚上和巴爾的摩抵達	飛行
I'd喜歡找從奧蘭多美國空中飛行克利夫蘭到達10點左右，晚上	飛行
請列出從拉斯維加斯到紐約和票價TWA航班	飛行
從達拉斯到舊金山的所有航班	飛行
什麼才是從舊金山到巴爾的摩的最低票價	飛行
告訴我到波士頓的航班奧克蘭	機票
我需要坐飛機離開費城亞特蘭大	飛行
我想找到北卡羅萊納州夏洛特拉斯維加斯我飛行想在日停留。路易	飛行
請告訴我任何美聯航航班包括5晚上波士頓和舊金山之間的連接	飛行
從辛辛那提到奧黑爾718後起飛的航班是美國人	飛行
希望從華盛頓到沃斯堡飛行	飛行
從伯班克到丹佛列表直達航班於下午6時抵達	飛行
顯示我要離開航空公司匹茲堡去舊金山參加下週一的日程	飛行
給我從夏洛特到巴爾的摩上午航班	飛行時間
列出從費城到舊金山的所有美聯航航班	飛行
我想從密爾沃基飛往奧蘭多	飛行
有沒有從波士頓到亞特蘭大的飛行這讓波士頓在下午和到達接近下午5點	飛行
讓我從一個密爾沃基方式飛往奧蘭多的航班離開上週三上午	飛行
告訴我所有的伯班克的航班	飛行
告訴我飛機，加拿大的航空公司使用	飛行
是的，我住在華盛頓，我想對舊金山之旅，其航空公司可能我用這行	飛機
請列出航班從亞特蘭大到費城	飛行
從拉瓜迪亞和肯尼迪國際機場飛往克里夫蘭的航班	飛行
告訴我美國航空公司航班上週三離開菲尼克斯和密爾沃基到達	飛行
顯示在漢莎航空公司的所有航班從波士頓	飛行
你能告訴我，波士頓和舊金山之間最便宜的航班	飛行
我想看到從巴爾的摩到費城的航班，請	飛行
給我從亞特蘭大到巴爾的摩航班	飛行
我希望有一個航班離開紐瓦克飛往洛杉磯的葉子在上午	飛行
從列出巴爾的摩飛往西雅圖的航班是停在明尼阿波利斯	飛行
我需要從匹茲堡到紐約的航班下午5點以後出發	飛行
告訴我從鳳凰城到密爾沃基的美國航空公司在週三的所有航班	飛行
這是達拉斯和巴爾的摩之間最便宜的航班七月十九	飛行
讓我從舊金山到丹佛的所有航班	飛行
該航空公司巴爾的摩和舊金山之間飛行	飛行
什麼航空公司從波士頓飛往丹佛	航空公司
休斯頓和拉斯維加斯之間往返航班	航空公司
什麼美國航空公司航班密爾沃基出發鳳凰在週六或週日	飛行
我在尋找，從安大略去威徹斯特和芝加哥停止飛行	飛行
什麼是最便宜的單程機票從丹佛飛往匹茲堡	飛行
什麼樣的航空公司從波士頓航班UA 281丹佛	機票
該航空公司波士頓和費城之間飛	航空公司
從巴爾的摩華盛頓機場到奧克蘭列表直達航班起程下午	航空公司
請列出的票價為所有從亞特蘭大到費城的航班八月第一	飛行
告訴我紐瓦克新澤西的是去航班從圣迭戈由休斯頓方式	機票
什麼航班有從達拉斯到匹茲堡在星期一早上	飛行
一種飛機是從費城一流的美國航空公司飛往舊金山達拉斯停止使用了什麼	飛行
什麼是往返票一流的奧克蘭和亞特蘭大之間的成本	飛機
我需要在週六從費城飛往達拉斯航班航班信息	機票
什麼夜航你從舊金山有丹佛八月第二十七個晚上團結	飛行
什麼是從費城飛往達拉斯的航班上月1991年第一	飛行
列出從波士頓到丹佛所有週二晚上航班	飛行
什麼匹茲堡和巴爾的摩之間的可用航班八月十一	飛行
我想從丹佛飛往匹茲堡的航班，然後從匹茲堡飛往亞特蘭大然後從亞特蘭大回到匹茲堡回到丹佛	飛行
給我從紐瓦克飛往坦帕航班上週五	飛行
是什麼從匹茲堡到巴爾的摩的航班	飛行
列出從達拉斯到舊金山的美國航空公司航班	飛行
什麼下午航班從匹茲堡飛往亞特蘭大在平日	飛行
什麼是縮寫UA均值	飛行
I'd喜歡舊金山美國聯合航空公司航班從達拉斯是815點以後的葉子	縮寫
什麼是從達拉斯到波士頓的美國航空公司928航班票價	飛行
從印第安納波利斯到華盛頓州西雅圖的航班	機票
該航空公司是最便宜的，從達拉斯飛往巴爾的摩十二月廿四	飛行
有多少是波士頓和華盛頓之間的往返頭等艙票價	航空公司
I'd喜歡尋找從坦帕到蒙特利爾的航班，使停止在紐約	機票
表明離開費城是去亞特蘭大在星期四一早離開航班	飛行
告訴我航班的航空公司或從愛場	飛行
有多少航班確實每家航空公司有一流的服務	航空公司
告訴我下週三的鳳凰和密爾沃基之間的航班	數量
告訴我從費城到巴爾的摩航班	飛行
來回機票，從匹茲堡到費城低於1000美元	飛行
告訴我從波士頓到舊金山的航班下午4點離開後上週五	機票
哪些呢碼Y立場	飛行
什麼是最便宜的往返航班從丹佛亞特蘭大	縮寫
你能告訴我是經濟艙從巴爾的摩到達拉斯的航班	飛行
地面交通丹佛	飛行
什麼地面交通可在丹佛機場	飛行
又有多少的費用是從波士頓機場到市區行駛	飛行
最早的航班從亞特蘭大飛往費城	機票
什麼從印第安納波利斯飛往孟菲斯國際	飛行
當是早上第一個航班從波士頓到丹佛	飛行
告訴我從納什維爾到ST的直飛航班。路易	飛行
顯示從亞特蘭大到巴爾的摩航班	飛行
其中一般米切爾國際位於	飛行
什麼是鑽	市
有沒有從舊金山到波士頓任何直飛航班每週四	縮寫
感謝您的信息，現在我會一大早喜歡到費城四月十六歲的航班從亞特蘭大信息	飛行
I'd喜歡去航班從波士頓到亞特蘭大下午離開上八月第六	飛行
我需要從丹佛飛往舊金山週二	飛行
什麼呢FF平均	飛行
我想從密爾沃基飛往奧蘭多週三晚上或週四早上任	縮寫
從匹茲堡到費城是下週二到達位於6點鐘位置的所有航班	飛行
列出所有航班從米切爾將軍出發	飛行
讓我從圣迭戈的一個單程票價邁阿密直飛	飛行
告訴我，從亞特蘭大到波士頓航班	機票
是什麼從達拉斯到波士頓的航班增量	飛行
告訴我從波士頓到DFW所有航班	飛行
什麼是從丹佛飛往波士頓聯航空公司的最新航班起飛時間	飛行
告訴我，多倫多和丹佛之間飛行的航空公司	飛行時間
週四I'd像ST公司的航班。聖彼得堡邁阿密	航空公司
請找我波士頓和費城，在費城到達接近下午5點之間飛行	飛行
什麼西北航空的航班在中午前離開丹佛	飛行
從丹佛飛往巴爾的摩	飛行
我試圖找到從哥倫布到鳳凰通過辛辛那提航班	飛行
在九月第三華盛頓和丹佛之間的航班??信息	飛行
從波士頓去什麼飛往丹佛的航班上午10點前	飛行
從夏洛特到巴爾的摩航班	飛行
是什麼限制AP57	飛行
請列出從達拉斯到費城週一所有航班	限制
列出從波士頓到舊金山聯合國所有航班	飛行
在那裡從波士頓到舊金山的任何航班。在達拉斯停留	飛行
我需要從舊金山到匹茲堡到紐約航班從匹茲堡，然後紐約到舊金山	飛行
什麼從亞特蘭大到ST航班。路易斯週二抵達的約230點	飛行
讓我從所有其他機場愛情領域的航班	飛行
讓我從蒙特利爾的所有航班	飛行
有一個航班從舊金山出發，晚上上月第七抵達奧克蘭	飛行
讓我從丹佛航班威徹斯特縣	飛行
你能告訴我從亞特蘭大最新晚上飛往丹佛的航班上七月初七	飛行
告訴我從丹佛或費城或匹茲堡巴爾的摩的所有航班	飛行
從拉斯維加斯飛往蒙特利爾的航班	飛行
並中西部快捷服務克利夫蘭	飛行
什麼樣的飛機呢三角洲飛早上8點前從波士頓八月第二丹佛	飛行
列出所有的航班到達，並在米切爾將軍國際出發	飛機
什麼是最便宜的單程票價從亞特蘭大到波士頓	飛行
好吧，我在尋找從坦帕到ST飛行。路易留下任何上午前一天10	機票
是什麼都從波士頓飛往丹佛的航班	飛行
你可以給我信息，運輸距離費城市中心的費城機場	飛行
什麼樣的飛機從費城前往舊金山週一下午一流的飛行在達拉斯停止	飛行
列出週一在大陸出發的所有航班中午從丹佛到芝加哥之前	飛機
我想知道從巴爾的摩飛往丹佛航班的頭等艙票價	飛行
從紐瓦克飛往克利夫蘭每天下午5點航班	機票
什麼是波士頓和舊金山之間的最低票價	飛行
週二像我'd從底特律飛往聖。聖彼得堡	機票
找到從舊金山到波士頓的班機上週三	飛行
什麼是從達拉斯到巴爾的摩最便宜的航班	飛行
什麼航班有從紐瓦克飛往西雅圖星期六	飛行
請列出所有米切爾將軍國際的起飛和著陸	飛行
請列出堪薩斯城亞特蘭大早上航班	飛行
我想在838離開波士頓，並在1110上午在抵達丹佛	飛行
我想從堪薩斯城到ST的一次飛行。保羅晚餐下午6點左右到達	飛行
名單不停從巴爾的摩到紐瓦克的航班上週三中午前	飛行
我在尋找來自波士頓的班機前往丹佛的一種方式和可能最便宜的方式	飛行
什麼地面交通可在波士頓機場	飛行
解釋限制AP請	飛機
我想一個來自多倫多的美國空中飛行到圣迭戈在丹佛停留請	縮寫
什麼是最低票價從丹佛飛往亞特蘭大	飛行
什麼航班有從紐約到拉斯維加斯	機票
多長時間才能讓堪薩斯城第一。保羅	飛行
我想從堪薩斯城到ST飛行。保羅在下午4點的情況下	距離
什麼是對大陸1291往返票價從達拉斯到舊金山和回報	飛行
我想去乘坐飛機在亞特蘭大飛波士頓	機票
I'd喜歡起飛的航班亞特蘭大八七並在科羅拉多州丹佛市第七月到達離開下午	飛機
顯示第一航班從費城飛往達拉斯	飛行
列出從費城飛往達拉斯的美國航空航班	飛行
找到波士頓和華盛頓之間的直飛航班華盛頓下午5點左右到達	飛行
給我從芝加哥到西雅圖在週六上午的歐陸航班	飛行
什麼地面交通是在明天達拉斯可用	飛行
告訴我從匹茲堡到巴爾的摩的航班	飛行
讓我知道從蒙特利爾飛往底特律的航班	飛行
讓我從舊金山到拉瓜直飛航班全部	飛行
告訴我從費城到巴爾的摩航班	飛行
告訴我所有的三角洲航班在下午離開匹茲堡12和4之間	飛行
請你告訴我從夏洛特到密爾沃基的所有航班	飛行
I'd喜歡找亞特蘭大最早的航班可能從舊金山	飛行
什麼航班都可以在週三從亞特蘭大到華盛頓特區	飛行
我想從舊金山到丹佛在週四上午航班信息	飛行
請列出從ST的航班。保羅堪薩斯城上週五晚上這餐服務	飛行
從芝加哥到丹佛在週六上午航班上大陸	飛行
我需要從芝加哥晚上下下週三返程航班堪薩斯城離開芝加哥周圍7天	飛行
我想對我們的空氣1039從丹佛飛往匹茲堡四月二十票價	飛行
什麼是前往密爾沃基往返於舊金山最便宜的方式	機票
什麼'重最低的單程票價從丹佛飛往亞特蘭大	飛行
什麼航班有從匹茲堡飛往舊金山週五	機票
從拉瓜迪亞至JFK航班	飛行
請告訴我從多倫多到ST回程航班號。聖彼得堡	飛行
給我找一個亞特蘭大最早波士頓出發，並從亞特蘭大最新的回程，這樣我可以在亞特蘭大的時間最長，但當天返回波士頓	航班號
美國航空公司的航班頭等艙從費城飛往達拉斯	飛行
列出從休斯敦到ST的航班。保羅	飛行
我想看到丹佛經濟艙票價費城	飛行
是什麼堪薩斯城伯班克的航班上週六可22在美西	機票
從ST航班。保羅·休斯頓	飛行
告訴我飛機，加拿大的航空公司使用	飛行
該航空公司有從舊金山飛往華盛頓的航班印第安納波利斯的方式	飛機
在那裡從波士頓到舊金山其停止在華盛頓的任何航班	航空公司
從波士頓到華盛頓特區上午10點前，所有航班十一月十一	飛行
丹佛費城星期一	飛行
直飛航班丹佛到堪薩斯城	飛行
我想從匹茲堡飛往亞特蘭大的直接教練航班	飛行
什麼航班在芝加哥有抵達大陸晚上11點以後	飛行
你可以列出所有的直飛航班從日出發。聖彼得堡和到達夏洛特	飛行
什麼是飛機的美聯航航班的21型	飛行
你能告訴我從聖何塞飛往納什維爾週六下午航班	飛機
請給我從丹佛飛往費城可用航班	飛行
來回機票，從巴爾的摩到費城低於1000美元	飛行
達拉斯奧克蘭週六	機票
什麼飛機上使用三角洲航班1222從堪薩斯城到鹽湖城	飛行
我需要去從費城飛往達拉斯	飛機
有多少航班就美國航空公司從波士頓到亞特蘭大有	飛行
只顯示大陸航班	數量
是什麼限制美聯社80	飛行
奧克蘭丹佛	縮寫
告訴我紐約市和拉斯維加斯之間的航班??上週日	飛行
你能告訴我在十月十五1991年從波士頓到奧克蘭航班	飛行
什麼從芝加哥到丹佛早上航班	飛行
是什麼從華盛頓飛往丹佛的航班	飛行
我想從匹茲堡晚間航班飛往洛杉磯六月第三	飛行
從拉斯維加斯到鳳凰的前提下，早晨	飛行
從密爾沃基到菲尼克斯空港的航班上週六或週日美國航空公司	飛行
從波士頓飛往匹茲堡的航班	飛行
我期待在達拉斯地面交通	飛行
什麼是波士頓和華盛頓之間的最早的航班	飛行
來自費城的頭等艙美國飛往達拉斯的航班上週三	飛行
I'd需要的信息，請從華盛頓加利福尼亞州舊金山航班	飛行
I'd像波士頓和華盛頓九月第三之間的航班??信息	飛行
列出每天從亞特蘭大飛往丹佛的航班	飛行
所有從巴爾的摩到費城不到1000塊錢航班	飛行
讓我從舊金山到波士頓八月三十航班第一	飛行
顯示波士頓和費城之間的航班	飛行
什麼豪華轎車服務在波士頓	飛行
有多少美國航班有舊金山	飛行
告訴我航班陷入熱戀場	數量
什麼是在舊金山的汽車租賃率	飛行
我想看到從丹佛飛往費城的航班	飛行
請列出對美國聯合航空公司和西北哪去了丹佛的所有航班	飛行
I'米從費城前往達拉斯	飛行
列出航班總數將由三角洲的所有機場	飛行
我需要預訂從紐瓦克到坦帕航班於四月第四	數量
告訴我九月十五舊金山和費城之間的所有航班	飛行
從舊金山到洛杉磯的所有航班	飛行
有大陸航空公司從波士頓到丹佛航班	飛行
從丹佛什麼飛行匹茲堡最先到達早上	飛行
當從波士頓到丹佛最早的航班	飛行
什麼才是一個航班，從巴爾的摩去西雅圖	飛行
什麼才是從波士頓到舊金山首飛	飛行
請給達拉斯機場地面交通	飛行
是什麼限制美聯社57	飛行
什麼是從波士頓最早的航班將在抵達丹佛	縮寫
是什麼在鹽湖城最早到達一個來自多倫多的航班	飛行
什麼是從丹佛最後一個航班到波士頓明天晚上	飛行
請出示從費城到丹佛機場下週日的所有航班	飛行
所有達拉斯往返航班和票價從匹茲堡12點後不到1100元	飛行
告訴我，低於200美元的單程費城和舊金山之間的所有票價	航班機票+
告訴我票價在星期二離開從丹佛到達拉斯	機票
我想從亞特蘭大到華盛頓特區週三航班	機票
他們是堪薩斯城st所有的直飛航班。保羅	飛行
沒關係告訴我所有的航班巴爾的摩	飛行
從匹茲堡飛往巴爾的摩上午10點到下午2點之間的航班	飛行
I'd喜歡從丹佛飛回亞特蘭大晚上航班	飛行
從辛辛那提到鹽湖城的美國航班	飛行
列出所有的航班，從米切爾將軍國際出發	飛行
明尼阿波利斯週一鳳凰	飛行
告訴我湖人地面運輸	飛行
從匹茲堡到洛杉磯週四晚上航班	飛行
我需要從華盛頓飛往舊金山，但我'd喜歡在達拉斯，你能告訴我航班，將做到這一點的時間表停	飛行
什麼樣的達拉斯和巴爾的摩之間的最低往返票價	飛行
從拉斯維加斯到紐約請名單的直飛航班上美國西部	機票
I'd喜歡看到從巴爾的摩到亞特蘭大的當天中午前抵達航班和I'd喜歡看到從丹佛飛往亞特蘭大當天中午前到達航班	飛行
還好只是在十一月十三，我想從亞特蘭大飛到丹佛，我需要知道哪些航班可用	飛行
什麼樣的從波士頓平面蒼蠅匹茲堡中午	飛行
從丹佛飛往鹽湖城	飛機
在那裡從波士頓飛往匹茲堡週三下週下午5點其他航班	飛行
航班信息從奧克蘭飛往丹佛	飛行
我想之間丹佛和舊金山從丹佛留在下午和下午5時抵達它必須是一個直飛航班	飛行
什麼航班有從費城到丹佛週三經濟艙	飛行
有沒有從邁阿密聯合航空公司航班前往華盛頓抵達中午左右	飛行
告訴我所有從紐約到密爾沃基的航班	飛行
什麼地面交通丹佛可用	飛行
什麼地面交通亞特蘭大可用	飛行
顯示所有航空公司與丹佛和達拉斯之間的航班	縮寫
頭等艙來回機票從印第安納波利斯到孟菲斯	航空公司
多少航班UA 297從丹佛飛往舊金山的成本	機票
我需要從辛辛那提往返飛行於加利福尼亞州聖何塞	機票
什麼西北航空的航班在中午前離開丹佛	飛行
告訴我返回從辛辛那提飛往鹽湖城直達	飛行
有起飛的航班從波士頓到亞特蘭大	飛行
告訴我航班列表上月第二十二留下DC達拉斯下午6時後離開DC	飛行
我的問題是我想要去舊金山，我住在丹佛，我想對美國聯合航空公司飛你有一個早期飛行	飛行
顯示來自匹茲堡的航班到舊金山	飛行
什麼航班有從達拉斯到休斯敦	飛行
讓我看看波士頓和華盛頓之間的所有航班	飛行
告訴我從波士頓到丹佛週三中午之前到達其在丹佛的所有航班	飛行
波士頓和奧克蘭之間的名單可能往返航班，每天	飛行
請告訴我的服務從波士頓到丹佛航空公司	飛行
什麼是由德爾塔航空公司提供亞特蘭大和DFW之間的航班??票價	航空公司
讓我再一次從巴爾的摩頭等艙票價達拉斯	機票
什麼是我的航班的選擇，以獲得從夏洛特到明尼阿波利斯抵達約下午7時在明尼阿波利斯	機票
告訴我，從巴爾的摩到達拉斯的航班	飛行
我想找到從波士頓到亞特蘭大的航班	飛行
在波士頓機場和市區之間的地面交通	飛行
我想下午4點之前，從達拉斯飛到舊金山週六抵達舊金山	飛行
是什麼從達拉斯到波士頓的航班，明天晚上或晚上	飛行
航班從丹佛飛往波士頓	飛行
讓我從舊金山到達拉斯大陸航空公司航班	飛行
發現我是波士頓和達拉斯之間的直飛航班	飛行
告訴我從達拉斯到舊金山票價	飛行
我想知道你有什麼欲購從速教練或經濟艙從巴爾的摩到達拉斯	機票
告訴我從達拉斯到舊金山的航班美國	飛行
什麼是從匹茲堡到亞特蘭大的一種方式最便宜的航班	飛行
顯示了從巴爾的摩到達拉斯的所有航班的價格在七月第二十九	飛行
哪些航班可以從達拉斯到亞特蘭大	機票
尋找多倫多聖地亞哥航班	飛行
你有什麼明天從亞特蘭大5點到舊金山後	飛行
什麼航班離開達拉斯亞特蘭大八月第二十七晚上	飛行
列出從波士頓到奧克蘭的所有航班	飛行
什麼才是從舊金山到亞特蘭大的最新航班	飛行
費城到波士頓週一	飛行
我想從洛杉磯到夏洛特的航班上一個工作日的早晨葉子	飛行
在丹佛地面運輸	飛行
什麼地面交通在巴爾的摩可以後天	飛行
什麼是週四華盛頓特區最早的航班從亞特蘭大	飛行
什麼是最新的航班離開華盛頓，丹佛	飛行
找旅行社安排從達拉斯往返航班匹茲堡晚上10點前晚上8點後抵達	飛行
給我從夏洛特到巴爾的摩一個航班上週二上午	飛行
我期待從匹茲堡到費城上午9點前離開航班	飛行
什麼是票價代碼QO平均	飛行
什麼航班有從巴爾的摩到舊金山	縮寫
我想從鹽湖城回到ST飛。聖彼得堡週三	飛行
我想從美國科羅拉多州丹佛市一個下午的航班飛往得克薩斯州達拉斯	飛行
有多少是達拉斯 - 沃斯堡國際機場和達拉斯之間的豪華轎車	飛行
從波士頓到舊金山的航班今天下午請，下午即離開	飛行
I'd喜歡從達拉斯到波士頓在週二的航班信息	飛行
在鳳凰地面交通	飛行
該機的顯示類型中午前從克利夫蘭出發飛往達拉斯	飛行
你怎麼知道丹佛汽車租賃	飛機
什麼是航空公司NW	飛行
顯示所有離開從多倫多到圣迭戈美國航空航班在華盛頓鋪設了	航空公司
I'd像八月第七在丹佛豪華轎車	飛行
我需要從夏洛特航班今晚拉斯維加斯與ST停止。路易斯，我想晚餐	飛行
我什麼時候可以從費城飛往達拉斯的一個星期六上午	飛行
給我從西雅圖大陸航班	飛行
什麼是票價代碼H	飛行
在巴爾的摩地面交通	縮寫
什麼歐陸航班從芝加哥到西雅圖上午10點之前在早晨吃一頓飯	飛行
告訴我從丹佛飛往波士頓的最新航班	飛行
告訴我九月十五舊金山和費城之間的所有航班	飛行
什麼從多倫多到費城的航班	飛行
告訴我從丹佛飛往舊金山週三下午航班	飛行
多少的費用是從達拉斯飛往美國巴爾的摩	飛行
什麼是波士頓和奧克蘭之間最便宜的單程票價	機票
有多少票價從塔科馬到蒙特利爾有一個辦法	機票
航班從丹佛飛往費城	數量
像我'd從哥倫布早飛到明天明尼阿波利斯	飛行
告訴我從巴爾的摩到達拉斯經濟航班	飛行
告訴我從匹茲堡到直流航班	飛行
費城到舊金山下週週二顯示航班	飛行
什麼是華盛頓最早的直飛舊金山	飛行
你能告訴我從巴爾的摩到達拉斯的航班	飛行
航班從密爾沃基前往芝加哥	飛行
什麼呢EWR立場	飛行
我想從達拉斯到亞特蘭大週三早上航班信息	縮寫
什麼是從印第安納波利斯到聖地亞哥的航班晚餐週三可能第十二	飛行
告訴我從丹佛飛往費城國際	飛行
告訴我從達拉斯到丹佛三角洲航班	飛行
告訴我有關的地面運輸在鹽湖城	飛行
告訴我從費城到丹佛在週一航班	市
美國巴爾的摩3724費城是什麼票價	飛行
沒關係，你可以告訴我，丹佛和亞特蘭大之間的飛行成本	機票
是什麼LS代表	飛行
告訴我從夏洛特到哥倫布的所有航班	縮寫
列出從費城到奧克蘭上週五下午的航班	飛行
描述匹茲堡機場	飛行
告訴我從愛領域的航班	飛機場
我想預定八月第二十七從巴爾的摩到舊金山航班上美國空氣	飛行
什麼航班降落在米切爾將軍國際	飛行
我想從亞特蘭大到華盛頓特區週四所有航班	飛行
請告訴我從丹佛飛往舊金山票價	飛行
什麼在多倫多豪華轎車服務	機票
多久地面交通從鹽湖城機場乘坐	機票
我想安排到舊金山美國航空公司航班從費城，使得在丹佛停止	飛行
我感興趣的飛行從波士頓到亞特蘭大	飛行
什麼航空公司航班始發於亞特蘭大十一月十七日中午和下午210在抵達舊金山	飛行
從列出華盛頓特區到佛羅里達州坦帕的所有航班	航空公司
告訴我從波士頓到達拉斯的航班	飛行
我想從密爾沃基飛往奧蘭多下午5點以後一種方式星期三離開	飛行
從匹茲堡飛往亞特蘭大的航班有最低經濟艙票價	飛行
I'd想知道從波士頓到舊金山最早的航班	飛行
你可以租一輛車在斯泰普爾頓國際機場	飛行
我想從丹佛去亞特蘭大往返，並在匹茲堡停止可能我有最低票價	飛行
有來自波士頓的增量飛往丹佛的航班	飛行
我想從亞特蘭大飛三角洲航空公司匹茲堡	飛行
該航班波士頓和巴爾的摩華盛頓之間	飛行
我想從丹佛飛往匹茲堡和亞特蘭大	飛行
從費城經亞特蘭大早餐飛往達拉斯的航班	飛行
什麼是匹茲堡和丹佛之間的最低票價單程	飛行
你有沒有從ST航班。聖彼得堡多倫多週一	機票
從波士頓飛往匹茲堡名單航班清晨離開八月第六	飛行
什麼是MCO	飛行
請告訴我從達拉斯飛往丹佛的航班	縮寫
我需要在週四航班上午8時從奧克蘭飛往鹽湖城之前	飛行
告訴我從波士頓到舊金山下午1點之前抵達的航班	飛行
什麼是最後一個航班從華盛頓到波士頓	飛行
是否有與在TWA達拉斯 - 沃斯堡停留奧克蘭和波士頓之間的航班	飛行
我想從費城到匹茲堡直飛航班	飛行
我想從孟菲斯到拉斯維加斯直飛航班三月第二	飛行
什麼才是從納什維爾最早的航班，以對美國塔科馬週二五月十八	飛行
告訴我從費城到巴爾的摩晚上航班	飛行
在那裡巴爾的摩任何的直飛航班從達拉斯留下與誰聯合航空公司七月初七	飛行
顯示從克里夫蘭到邁阿密是下午4點前到達航班	飛行
你有TWA航班從丹佛清晨離開舊金山	飛行
什麼是達拉斯最便宜的票價教練丹佛往返	飛行
什麼航班有從密爾沃基到上週六鳳	機票
是什麼從波士頓到丹佛清晨航班	飛行
我想找到從波士頓到奧克蘭最便宜的單程票價	飛行
什麼是從華盛頓特區的最新飛往丹佛的航班	機票
從匹茲堡飛往巴爾的摩上午10點到下午2點之間的航班	飛行
什麼飛機呢統一使用	飛行
讓我從舊金山到奧克蘭的所有飛行	飛機
找旅行社安排從波士頓的往返航班飛往匹茲堡	飛行
確實，美國的航空飛行從丹佛飛往匹茲堡	飛行
告訴我密爾沃基和奧蘭多之間的所有的每日航班	飛行
從丹佛到舊金山沒有丹佛費城航班列表	飛行
我想在大陸航空公司從波士頓離開使得在丹佛站和到達舊金山航班	飛行
告訴我從芝加哥飛往印第安納波利斯的航班	飛行
所有航班巴爾的摩12點後	飛行
你有華盛頓直飛週三航班從丹佛	飛行
I'd喜歡從波士頓飛往沃思堡	飛行
告訴我地面交通威徹斯特縣	飛行
請列出飛行時間從匹茲堡飛往紐瓦克	航空公司
什麼是從匹茲堡去一個辦法費城十一月十七票價	飛行時間
從匹茲堡飛往亞特蘭大九月第四什麼是最便宜的航班	機票
什麼才是票價從華盛頓到波士頓	飛行
不達美航空公司從匹茲堡飛往亞特蘭大	機票
告訴我從波士頓到舊金山航班	飛行
你有沒有從達拉斯到舊金山美聯航航班	飛行
告訴我從費城到丹佛在週日中午其離開後，費城的所有航班	飛行
告訴我從達拉斯飛往舊金山的航班星期三	飛行
什麼類型的飛機葉子從波士頓到華盛頓的上午9點	飛行
在TWA從哥倫布到ST航班。路易	飛機
什麼是從克里夫蘭到印第安納波利斯的航班星期三第十二屆	飛行
我想從費城到波士頓週三下午行程	飛行
I'd喜歡從底特律去圣迭戈週三晚上的六月二日	飛行
告訴我從丹佛飛往波士頓週四航班	飛行
我想從密爾沃基到ST每日航班列表中。路易	飛行
多少從波士頓到舊金山往返頭等機票費用	飛行
請告訴我從波士頓航班UA 201丹佛和飛行UA 343從波士頓到丹佛成本	機票
顯示航班離開邁阿密到克利夫蘭美國航空中午後離開	機票
請告訴我1600小時後，加州奧克蘭週四從亞特蘭大的航班	飛行
從華盛頓到舊金山十一月十二經濟艙所有航班下午5點以後	飛行
從華盛頓到舊金山美航最早的航班	飛行
航班是什麼，你下午6點之後，從波士頓不得不匹茲堡下週的週三	飛行
列出從丹佛飛往巴爾的摩的航班星期三上午1115和1245點之間在抵達巴爾的摩	飛行
什麼是從波士頓飛往達拉斯沃思堡最早的航班離開8月8號	飛行
什麼才是從亞特蘭大到丹佛頭等艙票價往返	飛行
什麼是從波士頓頭等艙機票匹茲堡週四	機票
從蒙特利爾飛往拉斯維加斯的航班	機票
我需要去從波士頓到達拉斯	飛行
什麼是丹佛舊金山下午航班	飛行
列出從丹佛飛往巴爾的摩的航班	飛行
什麼直飛航班可從奧克蘭飛往匹茲堡	飛行
什麼是我的明尼阿波利斯回到印第安納波利斯航班在中午選項	飛行
讓我從圣迭戈到紐瓦克的航班	飛行
好吧，我想飛行原產於丹佛去匹茲堡	飛行
是什麼從費城到丹佛的所有航班上週三	飛行
哪些航班可供週五從舊金山到波士頓	飛行
告訴我從匹茲堡飛往波士頓中午前離開它的所有航班	飛行
我需要十個人從丹佛飛往菲尼克斯請給我在一周內航班	飛行
我想從波士頓清晨前往丹佛	飛行
什麼航班從鹽湖城到拉斯維加斯	飛行
在底特律名單地面交通	飛行
什麼航班都可以星期二下午從匹茲堡飛往亞特蘭大	容量
從西雅圖到波士頓直飛或中轉航班	飛行
什麼航班從辛辛那提到坦帕	飛行
從美國科羅拉多州丹佛市到賓夕法尼亞州匹茲堡的所有航班	飛行
什麼呢EA平均	飛行
有沒有從納什維爾飛往休斯敦晚上明天	縮寫
什麼是你已經離開達拉斯費城的最新航班	飛行
告訴我下午6點後，奧蘭多在週三從密爾沃基航班	飛行
給我從亞特蘭大到丹佛的最低票價在5月第七屆請	飛行
告訴我從巴爾的摩到達拉斯的特價機票	機票
當是第一個起飛的航班從奧克蘭到波士頓	飛行
找到從費城飛往達拉斯亞特蘭大停止所有航班	飛行
列出美國航空從紐瓦克飛往納什維爾的航班	飛行
我可以看到所有從華盛頓到舊金山的航班，請	飛行
告訴我航班，從情場	飛行
我想就從丹佛飛往舊金山的航班上的美國聯合航空公司的一些信息	飛行
使用由TWA什麼飛機	飛行
我想從長灘到ST飛行。路易斯在達拉斯站	飛機
I'd喜歡看到所有從丹佛飛往匹茲堡的航班單程	飛行
I'd喜歡從費城飛往達拉斯1145點前抵達美國航空航班	飛行
請告知我從亞特蘭大到丹佛航班使用的飛機的類型之前正午12點	飛行
哪些呢票價碼Y平均值	飛機
是什麼從波士頓到費城早上航班	縮寫
第一類飛往舊金山，下週二美國航空公司	飛行
我需要的航班信息，週二離開巴爾的摩達拉斯波士頓和波士頓巴爾的摩	飛行
什麼是AP 57限制	飛行
現在告訴我航班從匹茲堡飛往費城	縮寫
在那裡，從亞特蘭大到費城沒有直飛的班機到達費城中午12點左右	飛行
什麼是從奧克蘭最早的航班華盛頓週日	飛行
什麼航空公司從波士頓飛往匹茲堡	飛行
我想從多倫多到聖地亞哥航班，在ST停止。路易斯是有航班	航空公司
你能告訴我從波士頓到舊金山最便宜的航班	飛行
什麼是匹茲堡機場匹茲堡市中心之間的距離	飛行
從拉斯維加斯到蒙特利爾	距離
什麼西北航空的航班在中午前離開丹佛	飛行
顯示在聯合航空公司從舊金山到丹佛華盛頓特區的所有航班	飛行
什麼是最新的航班從費城到波士頓	飛行
什麼時間做從波士頓到舊金山啟程大陸	飛行
I'd喜歡看到從匹茲堡飛往費城國際	飛行時間
什麼是從丹佛飛往匹茲堡的最低票價	飛行
列出所有從丹佛飛往費城國際	機票
請出示航班從丹佛到達費城	飛行
什麼航班你有從密爾沃基到坦帕	飛行
從巴爾的摩到華盛頓航班	飛行
給我從達拉斯到巴爾的摩上週六最便宜的航班	飛行
什麼是亞特蘭大和達拉斯之間的最昂貴的頭等艙機票	飛行
讓我從聖地亞哥到舊金山西南航空公司航班	機票
列出從丹佛飛往巴爾的摩每日航班，以一流的服務	飛行
告訴我所有的夏洛特在下週一下午5點左右到達的航班，請	飛行
多少頭等艙機票不團結今天從所有機場已經離開	飛行
有多少航班確實每家航空公司有預訂類k	數量
可我從舊金山飛往巴爾的摩	數量
I'd喜歡夏洛特的方式，使從洛杉磯到紐瓦克往返	飛行
航班信息從舊金山到匹茲堡	飛行
教練票價只有平日丹佛波士頓	飛行
列出最低成本航班從達拉斯到巴爾的摩	機票
我想從波士頓飛往亞特蘭大	飛行
有多少城市是由達美航空公司提供一流的航班	飛行
請給我航班時刻表從匹茲堡飛往費城	數量
告訴我在丹佛的地面交通	飛行
從達拉斯飛往波士頓的明天	飛行
從辛辛那提到美國休斯敦的航班	飛行
和航班從亞特蘭大離開奧克蘭下午5點以後離開	飛行
上週五我需要看到的是下午6點前離開亞特蘭大和抵達達拉斯的所有航班	飛行
告訴我從紐約到邁阿密在週二往返票價低於932美元的所有航班	飛行
我期待從波士頓飛往丹佛的航班有沒有中途停留，並且只在下午	飛行
I'd喜歡從費城飛往達拉斯1145點前抵達美國的航班	飛行
列出從長灘到哥倫布在週日的所有航班	飛行
給我從紐約到拉斯維加斯是在週日抵達所有直達航班	飛行
什麼是從波士頓到舊金山的航班將在明天	飛行
現在我需要底特律週二航班從鳳凰	飛行
什麼是從華盛頓到舊金山最早的航班	飛行
找到從波士頓到奧克蘭停止在丹佛任何飛行	飛行
好吧，讓我們看看你有沒有從亞特蘭大到波士頓三角洲航空公司的航班	飛行
你有沒有從鹽湖城到ST飛行。聖彼得堡在六月二日	飛行
告訴我從達拉斯到休斯敦直飛航班	飛行
你可以列出航班從拉斯維加斯出發，在聖地亞哥抵達	飛行
什麼是早上8點後的第一個航班從波士頓到舊金山	飛行
這在中午之前在丹佛西北和美國聯合航空公司直飛航班	飛行
從紐瓦克新澤西州俄亥俄州克利夫蘭航班	飛行
什麼是亞特蘭大最便宜的往返航班飛往匹茲堡	飛行
告訴我從紐約所有的最便宜的票價邁阿密留下週二	飛行
告訴我從安大略塔科馬一種方式的所有航班	機票
名單我的只有丹佛和奧克蘭之間的美聯航航班	飛行
什麼是從巴爾的摩到達拉斯在任何類的最低票價	飛行
給我最新的航班明天聯合航空公司從密爾沃基到塔科馬	機票
好吧，我'd就像從休斯敦到孟菲斯直飛航班到達孟菲斯在午後週二六月第一	飛行
我想從華盛頓前往匹茲堡二十八月	飛行
什麼航空公司飛亞特蘭大的出	飛行
之間找到丹佛和奧克蘭離開下午，到達下午5點附近的直飛航班	航空公司
從巴爾的摩到紐瓦克週三上午航班什麼	飛行
列出從亞特蘭大八月十五在波士頓到達的航班	飛行
什麼時候做飛行AA 459出發	飛行
我也需要去舊金山週三晚上從達拉斯	飛行時間
列出從長灘到哥倫布週六晚的所有航班	飛行
請給我所有從長灘加州到田納西州孟菲斯的航班	飛行
你有沒有從夏洛特到亞特蘭大的航班於六月第一	飛行
你能告訴我從達拉斯到巴爾的摩與經濟艙票價的航班	飛行
什麼從拉斯維加斯飛往鳳凰城上週六	飛行
喜I'米主叫從波士頓I'd像做出飛行要么奧蘭多或洛杉磯	飛行
是什麼，從紐約到拉斯維加斯的航班	飛行
什麼地面交通匹茲堡可用	飛行
請給我從亞特蘭大到波士頓在週三上午和週四下午航班	飛行
航班從密爾沃基到丹佛	飛行
哪些呢?指定為一頓飯	飛行
我想找到一個航班從坦帕去蒙特利爾製作在紐約停止，供應午餐飛行	縮寫
好吧，我只是想知道，從亞特蘭大到波士頓最廉價的票價	飛行
列出所有離開舊金山週一下午在匹茲堡抵達航班	機票
給我不航班從亞特蘭大飛往巴爾的摩票價	飛行
讓我從達拉斯飛往舊金山的航班增量票價	飛行
什麼是最新的晚上飛離舊金山華盛頓	機票
什麼是從波士頓首飛到亞特蘭大，什麼是來自亞特蘭大的最後一個航班到波士頓	飛行
什麼是對達美航空服務類	飛行
請列出所有航班週二達拉斯亞特蘭大	飛行
費城到舊金山，請	飛行
什麼航空公司飛往波士頓巴爾的摩	飛行
我需要花多少，每天對亞特蘭大地上找我從波士頓早班飛機從亞特蘭大最新的可能飛行回來	航空公司
並三角洲航空公司從丹佛飛往匹茲堡	飛行
列出從波士頓到亞特蘭大的所有航班點鐘在週四前5名	飛行
列出從巴爾的摩到舊金山上週五的所有航班	飛行
再告訴我從丹佛飛往費城的航班	飛行
這是什麼意思侯	飛行
讓我從舊金山到紐約的直飛航班全部	縮寫
我需要從鳳凰城到底特律起飛的航班星期一晚上	飛行
我想預訂從芝加哥到西雅圖航班六四	飛行
告訴我關於三角洲亞特蘭大早上航班	飛行
什麼才是從鳳凰城到鹽湖城最早的航班	飛行
我想從堪薩斯城到芝加哥飛下週三到達，晚上和返回的第二天	飛行
請列出從達拉斯到休斯敦週日航班上美國航空公司	飛行
什麼航班離開舊金山晚上8點以後，去達拉斯 - 沃斯堡	飛行
什麼是大陸的飛行這讓丹佛在1220點和去舊金山的航班號	飛行
什麼地面交通紐瓦克可用	航班號
我想費城飛往達拉斯七月十八	飛行
我想從波士頓前往丹佛	飛行
從匹茲堡去丹佛什麼航班下午2點後	飛行
I'd像拉斯維加斯TWA飛往紐約直飛	飛行
什麼是對美國航空公司頭等艙航班數量	飛行
我想看到從丹佛飛往費城的所有航班	航班號
波士頓匹茲堡	飛行
從華盛頓到舊金山的所有航班十一月十二	飛行
什麼樣的地面交通是在拉斯??維加斯提供	飛行
需要多少費用直接從費城飛往舊金山的美國航空公司	飛行
請列出飛行時間從紐瓦克飛往波士頓	機票
沒有增量波士頓和舊金山之間有什麼航班	飛行時間
給我從舊金山到華盛頓的航班，十二月第一	飛行
我想對航班將在亞特蘭大和達拉斯到達信息	飛行
請告訴我從華盛頓到舊金山加州航班	飛行
什麼航班從西雅圖到鹽湖城	飛行
從蒙特利爾飛往拉斯維加斯的航班和到達鳳凰在同一時間	飛行
告訴我從密爾沃基到奧蘭多在週三晚上或週四早上航班	飛行
列出從邁阿密到華盛頓直飛航班	飛行
你可以列出在聖地亞哥從多倫多出發的所有航班和降落在丹佛停留	飛行
給我從洛杉磯到匹茲堡週二航班	飛行
我需要從匹茲堡飛行逆轉丹佛請	飛行
我期待得到一個巴爾的摩機票到舊金山747離開八月第二十七	飛行
你可以給我匹茲堡和費城之間的航班	機票
地面舊金山	飛行
在丹佛中途停留的所有西北和美國聯合航空公司航班	飛行
什麼樣的票價代碼q和票價代碼B之間的區別	飛行
從舊金山到奧克蘭列表直達航班起程下午	縮寫
從鳳凰城到密爾沃基航班	飛行
給我從邁阿密到芝加哥在美國航空公司的所有航班	飛行
請列出從費城到多倫多早上航班	飛行
票價代碼有多少屬於經濟類	飛行
有美國航空公司打算從波士頓到舊金山六月第二十八飛行	數量
我要飛從亞特蘭大到費城	飛行
辛辛那提和坦帕之間早航班	飛行
四月十八我想預訂從夏洛特到巴爾的摩航班	飛行
什麼下午航班丹佛和達拉斯 - 沃斯堡之間可用	飛行
請列出從紐約到邁阿密在星期二的航班	飛行
什麼是最新的航班從費城到波士頓	飛行
列出從波士頓到亞特蘭大的所有航班下午6點在週三之後	飛行
從巴爾的摩華盛頓到奧克蘭列表直達航班的是445和515點之間到達	飛行
什麼是最早的航班從波士頓前往亞特蘭大離開	飛行
什麼樣的飛機都使用中途航空公司	飛行
我需要從波士頓飛往丹佛這個星期一	飛機
我想從加利福尼亞州奧克蘭到達拉斯的航班信息留在星期天早晨	飛行
什麼航班從波士頓離開匹茲堡上午	飛行
做任何的從波士頓到舊金山停止大陸航班丹佛	飛行
I'd喜歡看到所有的經濟艙票價從巴爾的摩到費城	飛行
什麼波士頓和華盛頓之間的直飛航班下午五點後抵達	機票
在丹佛地面交通	飛行
什麼才是從達拉斯飛往舊金山的航班達217車費	飛行
I'd喜歡看到從巴爾的摩到費城的所有航班	機票
從紐瓦克到波士頓的航班什麼下午5點以後	飛行
什麼航班沒有從波士頓到達拉斯	飛行
你有從亞特蘭大到北卡羅萊納州夏洛特下週一航班	飛行
從舊金山到丹佛	飛行
從亞特蘭大何去何從飛往華盛頓週四	飛行
請安排我從丹佛飛往舊金山的航班上美國空氣	飛行
告訴我從達拉斯到亞特蘭大週二航班	飛行
什麼是波士頓和巴爾的摩之間的最便宜機票	飛行
需要從匹茲堡到丹佛航班	機票
什麼是一流的票價從巴爾的摩到達拉斯	飛行
什麼是航空公司代碼DL代表	機票
告訴我最早的航班從克里夫蘭到孟菲斯	航空公司
你有沒有從匹茲堡飛往波士頓週三下週早上航班的任何	飛行
從匹茲堡到費城是下週二到達位於6點鐘位置的所有航班	飛行
請列出從堪薩斯城到丹佛的航班	飛行
請列出從加利福尼亞州安大略省的最短一站式飛往佛羅里達州奧蘭多	飛行
I'd喜歡尋找從波士頓到亞特蘭大直飛航班是葉的某個時候在下午和到達亞特蘭大的前一天晚上，	飛行
給我上月第二十七個從印第安納波利斯到奧蘭多航班和票價	飛行
告訴我從波士頓到巴爾的摩的航班	航班機票+
顯示從匹茲堡到奧克蘭航班	飛行
我需要後期飛行星期三從奧克蘭飛往鹽湖城	飛行
什麼是往返票的從波士頓飛往達拉斯奧克蘭離開七月第一成本	飛行
什麼是美國大陸航空公司的服務類的	機票
從蒙特利爾低於150美元的所有航班	飛行
請告訴我從紐約到邁阿密的所有往返航班	飛行
什麼航空公司有從波士頓到丹佛直飛午後航班	飛行
現在請給我最新的航班明天TWA從密爾沃基到塔科馬	航空公司
什麼是從波士頓的最後一個航班亞特蘭大	飛行
告訴我從丹佛飛往巴爾的摩的航班名單上團結八月份第三	飛行
什麼航班從大陸西雅圖抵達	飛行
讓我從聖地亞哥到紐約使用DC10的所有航班	飛行
告訴我地在波士頓和巴爾的摩運輸	飛行
我想在110點上八月二十一個航班從華盛頓離開波士頓	飛行
該航空公司從波士頓飛往華盛頓	飛行
給我留下夏洛特到亞特蘭大晚上7點左右下週二的航班	航空公司
告訴我紐瓦克新澤西的是去航班從圣迭戈	飛行
告訴我舊金山和華盛頓之間的往返票價	飛行
什麼是達拉斯和巴爾的摩之間的最便宜的往返飛行教練離開八月十	機票
請你告訴我一切從密爾沃基飛往蒙特利爾的航班	飛行
什麼地面交通丹佛可用	飛行
是什麼從聖何塞飛往納什維爾的航班上週四的二十	數量
告訴我所有的航空公司列表，提供企業級服務	飛行
告訴我關於在波士頓地面交通	航空公司
有從亞特蘭大到舊金山航班它連接在達拉斯	機票
有來自費城飛往奧克蘭在達拉斯停止	飛行
讓我從舊金山到亞特蘭大的航班	飛行
從費城到波士頓波士頓的航班上週一航班	飛行
什麼是波士頓和舊金山之間的最低票價統一收費	飛行
什麼是最小連接時間休斯頓國際	機票
列出所有的起飛和降落在米切爾將軍國際	飛行時間
告訴我從波士頓到亞特蘭大這明天中午離開後，亞特蘭大的所有航班	飛行
什麼從達拉斯飛往休斯敦霍比上週日	飛行
什麼是從波士頓飛往匹茲堡的所有航班上週三	飛行
給我從坦帕到夏洛特的航班上週日	飛行
讓我從舊金山最廉價的往返票價鹽湖城	飛行
從達拉斯到巴爾的摩航班什麼	機票
讓我從多倫多所有加拿大航空公司航班	飛行
什麼航班上大陸上週日到達芝加哥	飛行
告訴我通過nationair服務的城市	飛行
從鳳凰城到密爾沃基的航班上週三晚上	市
我想從亞特蘭大到華盛頓特區週三上午或週四9點前航班，我想下午4點以後離開信息	飛行
I'd喜歡從丹佛飛往巴爾的摩聯合航空公司航班	飛行
告訴我從達拉斯到休斯敦和從休斯敦到達拉斯的航班	飛行
告訴我從邁阿密飛往丹佛的航班	飛行
在波士頓機場和市區之間有地面交通	飛行
我想在機場和市區之間的地面運輸波士頓市的信息	飛行
什麼樣的下午1點離開華盛頓丹佛後的第一次飛行	飛行
我感興趣的飛機數量727飛行我想從華盛頓去亞特蘭大	飛行
什麼是教練的票價從夏洛特到紐瓦克週二下午航班	飛行
在鳳凰名單地面交通方式	機票
請找到從波士頓到舊金山的最低票價	機票
票價碼Y是什麼意思	機票
告訴我從波士頓到丹佛週二航班	縮寫
給我美的空調最便宜的頭等艙往返機票從克里夫蘭到邁阿密	飛行
顯示從匹茲堡通過丹佛連接到奧克蘭航班票價和信息	機票
列出所有留在週四早上從紐約市飛往蒙特利爾的航班	飛行
我需要從波士頓到匹茲堡航班	飛行
列出從舊金山到匹茲堡直飛週日所有航班	飛行
告訴我從丹佛飛往費城星期六星期天之後，中午離開後，所有航班	飛行
請列出從費城飛往達拉斯週二十月的美國航空公司航班第一	飛行
給我從印第安納波利斯到奧蘭多航班上的12月25日第七和第二十八	飛行
告訴我從奧克蘭飛往丹佛的航班	飛行
告訴我從多倫多到鹽湖城離開多倫多530點之間7航班	飛行
告訴我從明尼阿波利斯到聖地亞哥是晚上7點之前到達所有航班	飛行
我需要從費城飛往達拉斯航班	飛行
費城到波士頓週六	飛行
該航空公司從多倫多飛往圣迭戈和在丹佛停留	飛行
從夏洛特何去何從航班巴爾的摩上午	航空公司
什麼航班離開華盛頓和舊金山週三抵達	飛行
I'd喜歡從印第安納波利斯到多倫多起飛的航班星期四上午馬不停蹄	飛行
什麼是亞特蘭大和波士頓之間的最便宜的票價	飛行
地面運輸科羅拉多州丹佛市，我需要的信息	機票
列出所有的航班，從米切爾將軍國際起飛	飛行
我打算離開費城，我想要去舊金山，我想坐頭等艙美國人，我想在達拉斯停止你能告訴我什麼型號的飛機，你會飛行	飛行
什麼是最新的航班離開紐瓦克洛杉磯週三	飛機
發現從匹茲堡到舊金山最便宜的單程票價	飛行
告訴我從亞特蘭大到華盛頓特區在週四晚上的航班	機票
讓我從鹽湖城到ST的航班。聖彼得堡深夜週二	飛行
什麼是最新下午的航班出發舊金山並於11月在第九屆抵達波士頓	飛行
我想起飛的航班抵達丹佛亞特蘭大教練二等座	飛行
告訴我從夏洛特到亞特蘭大下週二航班	飛行
告訴我從亞特蘭大飛往華盛頓的航班	飛行
I'd喜歡採取從華盛頓停止飛行在丹佛和我的最終目的地舊金山	飛行
是什麼從波士頓到舊金山一月一日1992航班	飛行
請給我晚上航班離開費城舊金山週五	飛行
什麼才是最低往返票價從亞特蘭大到匹茲堡	飛行
有多少種不同的飛行類有	機票
告訴我從波士頓到亞特蘭大的航班列表中午離開後至下午7時之前抵達	數量
什麼航班有從丹佛飛往亞特蘭大	飛行
我希望有一個航班從夏洛特葉紐瓦克是葉子在下午或晚上	飛行
美國聯合航空公司有從達拉斯飛往舊金山航班的任何	飛行
讓我在週三上午波士頓丹佛美國聯合航空公司頭等艙航班	飛行
該航空公司提供的最低費率從達拉斯去巴爾的摩七月四日	飛行
我想計劃在美國航空公司從波士頓到丹佛航班	航空公司
名單晚上航班從明天鳳凰底特律	飛行
告訴我在多倫多的地面交通	飛行
告訴我從波士頓飛往匹茲堡週三下午6點以後的所有航班	容量
什麼是在丹佛可用的地面交通	飛行
告訴我從巴爾的摩到費城的航班	飛行
請給我從波士頓到亞特蘭大的航班上午在上午10點前	飛行
告訴我從紐約飛往邁阿密的航班	飛行
從洛杉磯飛往匹茲堡的航班	飛行
列出從印第安納波利斯奧蘭多出發或者所有往返航班12月25日第七或於十二月第二十八	飛行
什麼飛行可在中午從波士頓到華盛頓飛行什麼距離波士頓可用中午左右到華盛頓	飛行
您好我能得到一個單程票從密爾沃基到奧蘭多	飛行
我希望看到從丹佛飛往匹茲堡最便宜的航班	機票
讓我從舊金山到拉斯維加斯的航班	飛行
顯示從達拉斯到舊金山的航班下午	飛行
我想從匹茲堡到亞特蘭大最便宜的航班離開四月二十五和返回可能第六	飛行
從巴爾的摩在1000元往返車費費城	飛行
該航空公司提供丹佛	機票
從波士頓晚上7點到匹茲堡離開後什麼航班	航空公司
從鳳凰城到紐瓦克的航班	飛行
延胡索296丹佛費城什麼票價	飛行
告訴我從波士頓到舊金山停在達拉斯的航班	機票
告訴我從波士頓到亞特蘭大波士頓的航班和回程航班從亞特蘭大	飛行
多少個直飛航班從去達拉斯飛往奧克蘭七月第二十七	飛行
是什麼在丹佛的地面交通	數量
名單上週日離開大陸西雅圖的所有航班430點後	飛行
什麼是最新的航班從舊金山到華盛頓	飛行
多少三角洲的夜間飛行是一流的	飛行
什麼航空公司是	數量
告訴我地在華盛頓特區交通	航空公司
什麼航班離開匹茲堡年7月後第7日下午抵達並在舊金山	飛行
告訴我從巴爾的摩到費城的航班	飛行
告訴我早上從亞特蘭大飛往費城國際	飛行
我想從亞特蘭大飛往舊金山，在達拉斯停留	飛行
什麼是	飛行
我想長的海灘上週六航班從明尼阿波利斯	縮寫
我想飛到巴爾的摩	飛行
我想從華盛頓到波士頓在324點飛行八月二十	飛行
巴爾的摩和紐瓦克新澤西之間星期三上午航班	飛行
多久沒有考慮到從波士頓飛往亞特蘭大	飛行
從亞特蘭大到丹佛東部飛行825你能告訴我中午12點之前什麼類型的飛機使用	距離
七月十八I'd喜歡從紐瓦克到奧蘭多航班在上午	飛行
是什麼從丹佛飛往奧克蘭的航班	飛行
從匹茲堡何去何從飛往紐瓦克823後，在上午	飛行
地面運輸鳳凰	飛行
是什麼匹茲堡和舊金山之間的航班	飛行
現在我'd像沒有從達拉斯到亞特蘭大週二上午的航班從奧克蘭時間表	飛行
告訴我飛往匹茲堡的航班頭等艙從舊金山離開週二之後在上午8點和中午12點前	飛行時間
從匹茲堡到巴爾的摩航班4點之間到達5	飛行
什麼是我可以費城和舊金山之間獲得最低票價	飛行
什麼飛行你從達拉斯不得不丹佛8月在上午第二十七	機票
什麼是從匹茲堡下一個航班到舊金山三角洲飛行1059後	飛行
我需要從舊金山到費城航班	飛行
的確，從波士頓到舊金山飛大陸	飛行
是什麼票價代碼YN意思	飛行
我想從印第安納波利斯到多倫多直飛航班葉色週四上午	縮寫
給我所有從紐約飛往邁阿密的航班往返	飛行
讓我從舊金山到波士頓的航班可於十一月廿四	飛行
什麼是從費城到匹茲堡公務艙單程票價	飛行
什麼是在當天的最新航班從巴爾的摩到亞特蘭大	機票
什麼是舊金山大陸271的票價從達拉斯	飛行
讓我在九月第二十六個航班，請	機票
什麼類型的地面交通是可用在華盛頓	飛行
請告訴我，從亞特蘭大到費城清晨的航班上週三	飛行
告訴我那航空公司使用愛場	飛行
讓我在波士頓和舊金山之間的美國聯合航空公司的所有航班連接	航空公司
您好我'd喜歡從聖地亞哥到多倫多阿拉斯加航空公司的航班，請	飛行
請告訴我家航空公司從丹佛飛往波士頓停止費城的航班	飛行
列出了美國西北航空公司航班當天中午前離開丹佛	航空公司
還好怎麼樣夏洛特週日航班從坦帕	飛行
什麼類型的飛機確實從亞特蘭大到丹佛東部飛下午6點前	飛行
我想從波士頓飛往舊金山	飛機
我想在星期一清晨離開從亞特蘭大到巴爾的摩航班信息	飛行
列出所有在米切爾將軍國際機場抵達航班	飛行
我如何去費城市中心從機場	飛行
列出最便宜的航班從達拉斯到巴爾的摩	飛行
你可以請列出所有的航班班有	飛行
從匹茲堡飛往舊金山的航班列表	飛行
列出所有離開丹佛大陸上週日下午934航班後	飛行
什麼是最便宜的往返票價從匹茲堡飛往亞特蘭大	飛行
I'd喜歡尋找從拉斯維加斯到密歇根州底特律的航班葉色下午週一	機票
從列出ST最早的航班。保羅聖何塞	飛行
你將能夠把我在航班上與delta八月第二十七個上午從巴爾的摩離開舊金山	飛行
從舊金山到丹佛	飛行
舊金山到費城請	飛行
在哪裡呢加拿大國際航空公司飛	飛行
什麼航班前往從舊金山到達拉斯	飛行
什麼是從波士頓到亞特蘭大的單程航班的最低票價	飛行
能告訴我什麼航班從巴爾的摩到達拉斯與經濟艙票價	機票
什麼是從達拉斯到丹佛最低票價達美	飛行
請告訴我航班從費城飛往達拉斯的航班	機票
證券及期貨條例丹佛週一十一月十一1991	航空公司
什麼是商業類的代碼	飛行
從匹茲堡到巴爾的摩航班4點之間到達5	縮寫
找到從費城飛往達拉斯的哈特菲爾德停止	飛行
什麼樣的地面交通的有費城	飛行
從長灘飛往納什維爾的航班	飛行
顯示航班頭等艙對美國從達拉斯到舊金山國際	飛行
給我往返車費教練從達拉斯到巴爾的摩	飛行
I'd喜歡從聖地亞哥清晨平日航班飛往菲尼克斯	機票
有來自拉斯維加斯TWA飛往紐約	飛行
什麼直飛航班可從奧克蘭到費城5和6時之間抵達	飛行
我需要的航班從亞特蘭大飛往丹佛信息	飛行
什麼是最早發車時間從波士頓到丹佛	飛行
在丹佛地面交通	飛行時間
是否有任何4點的航班從華盛頓到丹佛	飛行
什麼是最後一個航班從巴爾的摩到波士頓	飛行
從紐瓦克新澤西州明尼阿波利斯航班	飛行
從達拉斯去什麼飛往舊金山的航班才6點週日下午	飛行
我需要聯合航空公司從丹佛飛往巴爾的摩定於十二月十七頭等車票	飛行
給我從印第安納波利斯到奧蘭多票價的航班上月第二十七	機票
我要飛從波士頓到巴爾的摩	飛行
告訴我從匹茲堡飛往亞特蘭大其下午5點後天保留所有航班	飛行
列出所有美國航空公司的航班離開其鳳週三停在密爾沃基	飛行
告訴我從波士頓到華盛頓週一航班	飛行
列車到紐瓦克	飛行
告訴我在舊金山的地面交通安排在週四晚上	飛行
我找一個航班離開波士頓在12點鐘位置	飛行
我如何從波士頓到匹茲堡	飛行
有來自費城下午航班到達晚上在丹佛	飛行
什麼是星期一上午紐約和洛杉磯之間的票價	飛行
是對增量航班離開舊金山在225點抵達費城1158點是什麼類型的設備上使用的飛行	機票
告訴我從波士頓到直流上午9時之前抵達航班列表上月第二十二	飛行
I'd喜歡採取在波士頓和土地在達拉斯 - 沃斯堡開始飛行，但我'd喜歡在費城停	飛行
有多少美國航空公司的航班離開丹佛六月十	飛行
告訴我從波士頓到舊金山航班	數量
我在尋找一種從聖何塞去休斯敦五卅飛行和中午之後葉	飛行
告訴我這經過亞特蘭大三角形或TWA航班	飛行
其中美國航空公司航班經過丹佛	飛行
我需要從亞特蘭大飛往北卡羅萊納州夏洛特下星期一	飛行
告訴我哪個航空公司有從匹茲堡飛往舊金山週一九月第二個航班	飛行
我需要從堪薩斯城到芝加哥下週三在晚上到達芝加哥約700航??班	航空公司
什麼頭等艙機票可在七月二十五分之一，從1991年丹佛巴爾的摩	飛行
什麼地面運輸在巴爾的摩可用	飛行
顯示從匹茲堡飛往舊金山的所有航班和票價	飛行
顯示從丹佛飛往奧克蘭，經過12點鐘到達航班	航班機票+
什麼是飯代碼的立場為	飛行
確實有增量從波士頓到舊金山午後飛行	縮寫
是什麼從波士頓到舊金山航班	飛行
請告訴我從印第安納波利斯的孟菲斯單程頭等艙機票	飛行
請告訴我從達拉斯到亞特蘭大週一航班	飛行
人列表號可以在匹茲堡和巴爾的摩之間的蒼蠅每種類型的飛機進行	飛行
I'd像上最便宜機票往返從匹茲堡到波士頓信息	容量
大陸航空飛行從丹佛飛往匹茲堡	機票
I'd喜歡尋找從波士頓到費城最便宜的單程票價	飛行
航空公司和航班號從哥倫布到明尼阿波利斯	機票
什麼航空公司從華盛頓特區到哥倫布	飛機場
往返票價從巴爾的摩到費城小於從丹佛1000元往返車費費城不到1000塊錢從匹茲堡往返票價費城低於1000美元	航空公司
什麼做這些成本	機票
讓我在大陸從印第安納波利斯聖地亞哥下午航班明天	機票
給我的航空公司匹茲堡列表	飛行
從邁阿密飛往克里夫蘭的航班	航空公司
你能告訴我，如果有波士頓機場和波士頓市區之間的地面交通	飛行
什麼三角洲航班從匹茲堡飛往舊金山	飛行
告訴我晚上到費城的所有航班	飛行
從加利福尼亞州安大略省的最短飛行到佛羅里達州奧蘭多	飛行
在那裡華盛頓晚上9點以後的任何航班從舊金山	飛行
我需要從加利福尼亞州圣迭戈到印第安納州印第安納波利斯的航班在下午離開週二	飛行
I'd喜歡也可以預定從匹茲堡單程航班亞特蘭大七月二十日最便宜的	飛行
在洛杉磯有什麼豪華轎車服務	飛行
告訴我從匹茲堡飛往舊金山的航班	飛機
什麼航班有從納什維爾到休斯敦明天晚上供應正餐	飛行
多少頭等艙機票不團結今天所有城市都留下	飛行
顯示從舊金山到波士頓8月8號的所有航班	數量
什麼才是從休斯敦到達拉斯的最新航班	飛行
請列出從休斯敦到密爾沃基的美國航空公司航班	飛行
我想預定在四月第六從坦帕清晨飛往夏洛特	飛行
告訴我從丹佛到DC上週三航班	飛行
告訴我從費城飛往達拉斯與一站式的航班	飛行
從波士頓早上飛往費城	飛行
什麼樣的價格是在波士頓的一個豪華轎車服務	飛行
是什麼從奧克蘭到華盛頓週日航班	飛行
什麼航班團結休假拉瓜迪亞聖何塞和晚上10點左右到達	飛行
是什麼從匹茲堡到丹佛和背面的航班	飛行
什麼才是最便宜的達拉斯到亞特蘭大的航班時間為2後，在下午	飛行
是什麼從蒙特利爾飛往芝加哥的航班	飛行
列出到達的航班和時間，在中午前從波士頓在達拉斯抵達航班	飛行
什麼是票價碼Q	飛行
沒事什麼我們航航班在下午從印第安納波利斯離開聖地亞哥130後	縮寫
週一我想從北卡羅萊納州夏洛特前往亞利桑那州鳳凰城我想下午4點之前在鳳凰抵達	飛行
給我從紐約到拉斯維加斯的航班，並從孟菲斯到拉斯維加斯的航班在同一時間內到達	飛行
從亞特蘭大飛往請	飛行
告訴我從亞特蘭大到奧克蘭這抵達奧克蘭下午5時前，端出週四所有航班	飛行
什麼是從密爾沃基到明天西雅圖的最新航班	飛行
什麼航班有上週三晚上從丹佛到SFO	飛行
哪些呢限制美聯社57	飛行
我需要從芝加哥飛回堪薩斯城離開芝加哥7左右，晚上下週四	縮寫
我需要從亞特蘭大到巴爾的摩航班明天	飛行
告訴我航空公司從匹茲堡打算去丹佛，然後繼續到舊金山週一	飛行
列出哪些離開西雅圖大陸的所有航班，並在芝加哥430 pm以後上週日抵達	航空公司
我想找到一個航班，從拉瓜迪亞機場前往聖何塞我想飛行是在美國聯合航空公司和聖何塞晚上10點左右到達	飛行
從丹佛飛往費城的航班票價包括	飛行
告訴我從愛場離開航班	飛行
我想從丹佛飛往舊金山與至少一個站	飛行
什麼是我可以從華盛頓到舊金山的最新航班	飛行
是什麼從丹佛飛往巴爾的摩的航班聯合航空公司	飛行
顯示從巴爾的摩到達拉斯我的廉價航班	飛行
芝加哥到舊金山大陸	飛行
上午八月第三個前10名名單在巴爾的摩從波士頓到達的航班	飛行
什麼樣的飛機呢三角洲利用早上8點前從波士頓八月第二丹佛	飛行
顯示從巴爾的摩到達拉斯在星期一晚上的所有航班，並在每次飛行的成本	飛機
哪些航班可以從波士頓到丹佛	飛行
這裡是萊斯特·皮爾遜機場	飛行
在四月二想從丹佛大約8點早上飛往匹茲堡	市
喜像我'd從哥倫布飛往鳳凰城，並停止在前進的道路上辛辛那提	飛行
之前在週二10點有一個747，從巴爾的摩飛往舊金山	飛行
I'd喜歡安排兩個朋友飛入人們的洛杉磯下週六晚上，一個從堪薩斯城來，另一種是從拉斯維加斯來	飛行
給我從鹽湖城到抵達紐約市的航班下午6點前	飛行
我需要從辛辛那提到聖何塞航班在晚上6後離開	飛行
什麼才是從費城一流票價舊金山的成本	飛行
達拉斯到舊金山下午4後請留下	機票
找到從華盛頓到舊金山航班上週二	飛行
波士頓和舊金山之間的航班??列表服務於早餐	飛行
下午航班離開舊金山抵達波士頓	飛行
我想看到從巴爾的摩到費城的航班	飛行
什麼是最新的航班離開拉斯維加斯安大略	飛行
所有Delta飛往無處不在，如果你能	飛行
我想看到從巴爾的摩到費城的所有航班	飛行
告訴我從多倫多到辛辛那提的航班	飛行
好吧，我需要看到達拉斯和巴爾的摩之間的美聯航經濟艙航班	飛行
列出所有航班下午離開巴爾的摩和週四抵達亞特蘭大	飛行
告訴我到巴爾的摩教練在週三中午12點左右從波士頓的航班	飛行
列出從波士頓到舊金山聯合航空公司的所有航班	飛行
有多少航班在米切爾將軍國際到達	飛行
最低票價從孟菲斯到西雅圖	數量
讓我從舊金山到明尼阿波利斯航班	機票
請告訴我從匹茲堡飛往亞特蘭大週三早上供應早餐航班	飛行
什麼樣的航空公司從波士頓航班UA 281丹佛	飛行
給我所有從孟菲斯到夏洛特的航班	航空公司
告訴我從費城飛往達拉斯的航班在亞特蘭大停止	飛行
告訴我從丹佛飛往費城費城的航班和航班從匹茲堡	飛行
也給我奧克蘭和波士頓之間的航班??列表	飛行
顯示從波士頓到費城首飛	飛行
什麼是YN代碼	飛行
什麼是票價代碼H	縮寫
我需要的是在舊金山到達9點日星期五下午和葉從巴爾的摩飛機	縮寫
列出印第安納波利斯之間的所有往返航班和奧蘭多二十七個十二月	飛機
顯示從丹佛飛往奧克蘭12和1點之間抵達航班	飛行
是什麼從夏洛特到亞特蘭大週二返回七月十三航班	飛行
直飛航班西雅圖波士頓	飛行
什麼是在費城機場的名字	飛行
好吧，我想知道從克利夫蘭到達拉斯的飛行中使用飛機的型號，請	飛機場
顯示最後一個航班從費城到波士頓	飛機
我想從波士頓飛往亞特蘭大的航班	飛行
有多少是來自拉斯維加斯的718班機到紐約TWA	飛行
從鳳凰到密爾沃基的航班美國時	機票
什麼是從丹佛到亞特蘭大最便宜的單程航班	飛行
在亞特蘭大多少才租車費用	飛行
從匹茲堡飛往波士頓的航班名單在下午3後離開	飛行
告訴我從紐瓦克飛往洛杉磯的航班	飛行
列出從邁阿密到紐約上週日直飛航班與小於466元的車費一起	飛行
我需要從ST航班的列表。聖彼得堡佛羅里達州塔科馬華盛頓明天就要走了，我想有一個停留在密爾沃基請	飛行
什麼從洛杉磯飛往明尼阿波利斯航班	飛行
告訴我從紐約飛往聖何塞的特價機票，往返	飛行
顯示從匹茲堡到奧克蘭航班	飛行
顯示從舊金山飛往匹茲堡的所有航班星期一	飛行
I'd喜歡看到從匹茲堡到費城的航班	飛行
讓我看看航空公司的縮寫	飛行
列出從巴爾的摩飛往丹佛的頭等艙機票	航空公司
你能告訴我所有從蒙特利爾飛往夏洛特的航班	飛行
我想從費城飛往達拉斯，並在亞特蘭大停留	飛行
我謹飛從匹茲堡飛往亞特蘭大	飛行
芝加哥密爾沃基	飛行
讓我從舊金山到波士頓星期五早上航班	飛行
哪些航班可以從亞特蘭大到華盛頓特區週三	飛行
從堪薩斯城飛往克里夫蘭的航班上週三下午5點之前到達	飛行
來自舊金山的美國航班，請	飛行
讓我知道從匹茲堡到巴爾的摩航班	飛行
告訴我從波士頓到丹佛的航班	飛行
你有票價從奧克蘭機場前往奧克蘭市中心	飛行
還好給我離開丹佛後，晚上7點下週一抵達波士頓的航班	機票
請列出飛行時間為波士頓飛往匹茲堡	飛行
什麼是票價代碼QW和QX	飛行時間
什麼航班離開匹茲堡掘金在週一晚上	縮寫
我需要從亞特蘭大到丹佛最廉價的直航留下五七	飛行
告訴我從洛杉磯到匹茲堡，其在美國匹茲堡上週一抵達的航班	飛行
從亞特蘭大到波士頓航班列表週三下午	飛行
什麼是你最早的早上的飛機從印第安納波利斯到夏洛特	飛行
I'd喜歡從聖何塞飛往納什維爾的航班上週五六月三日上午	飛行
我想從多倫多首飛到蒙特利爾下週五	飛行
我想，ST公司的直飛航班。聖彼得堡夏洛特留在下午	飛行
從達拉斯亞特蘭大顯示航班其中下午2點和下午6點之間出發	飛行
什麼是從亞特蘭大到華盛頓週四最早的航班	飛行
從匹茲堡飛往巴爾的摩名單航班上週四早上不停	飛行
我感興趣的一個航班從匹茲堡飛往亞特蘭大	飛行
從波士頓到達拉斯的聯合航空這條橫貫大陸飛行使得在費城短暫停留	飛行
有多少人適合在73S	飛行
從辛辛那提到洛杉磯718點以後起飛的航班	容量
告訴我，從紐約到邁阿密在週二和去從邁阿密到紐約上週日所有航班	飛行
從丹佛在1000元往返車費費城	飛行
請列出從費城到多倫多航班	機票
給我從匹茲堡到洛杉磯週四晚上的航班	飛行
是否有任何美國航空公司的航班在下午飛入匹茲堡12和4之間	飛行
告訴我從達拉斯到匹茲堡其離開週一上午08點後所有航班	飛行
告訴我從巴爾的摩飛往費城國際	飛行
讓我在九月十五與發車時間舊金山和費城之間的所有航班12點後	飛行
從匹茲堡飛往巴爾的摩	飛行
列出波士頓和奧克蘭之間，並使用達美航空之間的奧克蘭和波士頓所有的每日航班	飛行
我想找到早期早晨或傍晚週日六月十三謝謝週一六月十四從哥倫布到明尼阿波利斯航班	飛行
列出了三角洲的所有機場之間的航班??總數	飛行
告訴我，上週四早上離開從亞特蘭大到華盛頓和包括膳食是否提供什麼價格都在航班	數量
我需要在大陸上月第五次從芝加哥到西雅圖轉機	飛行
我想我應該採取什麼亞特蘭大的航班從波士頓早上8點之前離開	飛行
沒有飛行UA 281從波士頓到丹佛留在星期二	飛行
沒有增量飛機飛DC10	飛行
是什麼從波士頓到巴爾的摩的航班	飛機
從舊金山到費城航班信息	飛行
什麼航班從波士頓到舊金山，達拉斯停止	飛行
我想從亞特蘭大到丹佛航班有最便宜的單程票價	飛行
定義航空公司馬力	飛行
什麼是最早的航班從安大略孟菲斯	航空公司
是什麼從匹茲堡到亞特蘭大最便宜的單程航班	飛行
告訴我從丹佛飛往舊金山的航班	飛行
從舊金山最低票價聖地亞哥	飛行
什麼從聖航班。保羅堪薩斯城上週五晚餐送達	機票
沒關係，我們'重新從華盛頓前往丹佛頭等艙機票I'd想知道一個頭等艙機票的費用	飛行
告訴我從匹茲堡飛往舊金山的航班時刻表	機票
從邁阿密到紐約的所有航班	飛行時間
什麼時間週二上午755航班在離開華盛頓抵達舊金山	飛行
告訴我從亞特蘭大飛往舊金山的所有航班	飛行時間
從堪薩斯城飛往克里夫蘭的航班	飛行
請給我從達拉斯的所有航班奧克蘭中午前	飛行
什麼是一個單程從匹茲堡飛往亞特蘭大成本	飛行
我需要從堪薩斯城密蘇里州的航班到猶他州鹽湖城的列表	機票
現在我需要從拉斯維加斯到洛杉磯的另一架飛機抵達還有在下午晚些時候什麼才是可用於該	飛行
你能告訴我從亞特蘭大到波士頓最廉價的票價	飛行
從紐瓦克到波士頓的航班什麼下午5點以後	機票
告訴我聖何塞的特價機票，往返紐約聖何塞到達下午7點之前	飛行
I'd喜歡從波士頓去亞特蘭大下午5點以後的某個時候，你能告訴我，能做到這一點對我來說航班	飛行
給我從亞特蘭大到巴爾的摩航班	飛行
我需要在星期一下午從洛杉磯到匹茲堡航班	飛行
從蒙特利爾飛往拉斯維加斯的航班和到達鳳凰在同一時間	飛行
我想從費城前往舊金山，在達拉斯停留	飛行
什麼是從波士頓最貴飛往達拉斯的航班	飛行
在達拉斯我想在地面交通信息	飛行
告訴我第一週三亞特蘭大和華盛頓之間的航班	飛行
請告訴我從波士頓到舊金山航班	飛行
汽車租賃在波士頓	飛行
請告訴我從波士頓航班服務的航空公司丹佛從丹佛和費城費城到波士頓	飛行
從休斯敦最新飛往聖何塞	航空公司
列出從亞特蘭大到丹佛最早的航班在星期一	飛行
尋找從DC到科羅拉多州丹佛的航班	飛行
下午5點之前，從堪薩斯城飛往克里夫蘭的航班上週三	飛行
一種飛機是從費城一流的美國航空公司航班飛往舊金山，達拉斯停留用什麼	飛行
請給我達拉斯沃斯堡機場和達拉斯市中心之間的地面交通信息	飛機
告訴我，提供一頓飯從波士頓八月第二丹佛最早的航班	航空公司
沒事做臨時工必須從達拉斯到舊金山的航班	飛行
什麼是對我們空氣中的往返車費節儉從波士頓到舊金山	飛行
什麼是你從華盛頓到波士頓的最後一趟在八月第二十七	機票
告訴我從愛領域的航班	飛行
I'd喜歡納什維爾美國一航班從紐瓦克	飛行
什麼是最便宜的航班從亞特蘭大到波士頓	飛行
在那裡從密爾沃基到塔科馬任何航班上週五六月十一	飛行
什麼才是從波士頓到費城最早的航班	飛行
在美國空氣有多少航班離開奧克蘭在7月24日第七到波士頓直飛	飛行
我怎樣才能從波士頓市中心波士頓機場	飛行
我想從舊金山到匹茲堡10點以後航班上週五上午	飛行
我想預訂從丹佛到匹茲堡航班於七月十五I'd喜歡它是最便宜的航班	飛行
什麼類型的飛機葉子從波士頓到華盛頓的上午9工作日期間	飛行
列出丹佛的聯合航空公司的所有航班下午從舊金山	飛機
在上午9點之前，從亞特蘭大到華盛頓特區的航班上週四出發信息	飛行
什麼是從舊金山到匹茲堡最便宜的航班上週日	飛行
告訴我從丹佛或費城或匹茲堡巴爾的摩的所有航班	飛行
有沒有從芝加哥飛往明尼阿波利斯上週六在大陸的任何航班	飛行
我需要從費城到達拉斯的飛行，在亞特蘭大站	飛行
從安大略飛往奧蘭多的航班	飛行
我想看到從丹佛飛往費城國際	飛行
讓我在波士頓機場地面交通的列表	飛行
有多少航班有大陸進出的亞特蘭大	飛行
列出從多倫多到鹽湖城的航班	數量
列出巴爾的摩抵達丹佛八月第三個航班	飛行
告訴我從巴爾的摩到費城的航班，請	飛行
我需要從波士頓到舊金山起飛的航班在下午和晚上抵達謝謝	飛行
告訴我從華盛頓到波士頓的航班	飛行
從費城到奧克蘭航班	飛行
什麼是從丹佛飛往亞特蘭大的航班票價	飛行
美國聯合航空公司航班在丹佛停	機票
多遠是從舊金山機場	飛行
什麼航班從西雅圖出發前往波士頓通過明尼阿波利斯	距離
請列出從加利福尼亞州安大略省的航班佛羅里達州奧蘭多	飛行
什麼類型的地面運輸在那裡舊金山機場	飛行
列出所有從匹茲堡飛往費城國際	飛行
I'd像從亞特蘭大到丹佛早上的航班飛行信息	飛行
什麼地面運輸夏洛特可用	飛行
有沒有紅眼航班從聖何塞飛往納什維爾週三十九的可能	飛行
我期待從奧克蘭到亞特蘭大1045點前離開航班	飛行
告訴我從亞特蘭大飛往丹佛的特價機票	飛行
從丹佛飛往匹茲堡的航班上週四	飛行
從克里夫蘭到堪薩斯城航班	飛行
告訴我從巴爾的摩到奧克蘭航班，請	飛行
告訴我從波士頓到丹佛週三最早的航班	飛行
從丹佛航班信息舊金山	飛行
給我最昂貴的一種方式頭等艙票價從巴爾的摩到達拉斯	飛行
什麼是最早的早上航班從舊金山到波士頓	機票
什麼航班有從波士頓到丹佛在星期一早上	飛行
出發洛杉磯目的地夏洛特上一個星期一的早晨離開該航班	飛行
我需要從亞特蘭大到巴爾的摩直飛航班晚上7點到達，請	飛行
我需要從丹佛機場到市中心	飛行
我想了票，從科羅拉多州丹佛到離開佐治亞州亞特蘭大，在美國匹茲堡停止	飛行
什麼航空公司馬力	機票
列出從波士頓飛往奧克蘭採用大陸航空公司的每日航班	航空公司
告訴我從杜勒斯國際機場到舊金山的航班下午6時後離開	飛行
現在讓我從匹茲堡飛往丹佛	飛行
今天航空公司有一流的航班	飛行
什麼航班抵達有在芝加哥晚上9點以後大陸	航空公司
什麼航班你在九月二十日上午對從匹茲堡飛往舊金山的美國聯合航空公司和在丹佛停留	飛行
我需要費城和亞特蘭大之間飛行	飛行
從波士頓到舊金山吃飯什麼類型的供應歐陸飛行1765	飛行
I'米在邁阿密和I'd喜歡旅行拉斯維加斯星期天	飛行
讓我知道從波士頓來到丹佛的航班	飛行
什麼是所有的航班進出亞特蘭大的機場	飛行
什麼是下午的航班從達拉斯離開舊金山的美國航空公司	飛行
什麼是美國的“從波士頓到華盛頓最後一次飛行S於七月二十一	飛行
我想從匹茲堡飛往巴爾的摩巴爾的摩港航班信息上午週四10點前	飛行
對不起我想預訂從亞特蘭大到科羅拉多州丹佛航班	飛行
有來自巴爾的摩的往返航班丹佛達拉斯連接	飛行
什麼航班，目前波士頓和達拉斯 - 沃斯堡之間可用	飛行
從孟菲斯到拉斯維加斯的航班是什麼	飛行
上月第六我想預訂從坦帕清晨飛往夏洛特	飛行
列出從波士頓到舊金山的所有航班至少有3站	飛行
什麼航班從鳳凰城到任何地方離開	飛行
什麼航班可用週日下午從奧克蘭飛往達拉斯	飛行
確實美國航空公司提供從波士頓到奧克蘭航班停靠在丹佛	飛行
I'd喜歡從坦帕飛往蒙特利爾	飛行
讓我知道從匹茲堡飛往亞特蘭大週三中午前離開這和提供早餐的所有航班	飛行
告訴我從紐約到洛杉磯的航班與停在密爾沃基	飛行
什麼是從費城飛往達拉斯一流的最早的航班	飛行
告訴我從邁阿密到紐約留在一個星期天的最便宜的票價	飛行
我需要預訂從丹佛到波士頓	機票
告訴我所有的達拉斯 - 沃斯堡，要么舊金山或奧克蘭之間的航班??是出發和下午7點之間5	飛行
亞特蘭大匹茲堡七月十三	飛行
請告訴我從伯班克到塔科馬所有往返航班	飛行
I'd喜歡從波士頓飛往舊金山	飛行
給我所有從紐約飛往邁阿密的航班往返	飛行
我想從印第安納波利斯前往休斯敦	飛行
航班離開芝加哥到納什維爾	飛行
你可以列出從奧蘭多最廉價的往返票價堪薩斯城	飛行
讓我從圣迭戈到華盛頓的航班	機票
多少的費用是從亞特蘭大飛東航波士頓	飛行
什麼是單程票從波士頓到華盛頓最低的成本	機票
我想從舊金山飛往波士頓週三時間表	機票
告訴我在芝加哥的地面交通	飛行時間
什麼樣的地面交通的有達拉斯	飛行
給我最早的航班，明天從日美國西北航空公司。聖彼得堡密爾沃基	航班機票+
有多少人適合在72S飛機	飛行
什麼是從華盛頓到舊金山最便宜的航班上週五	容量
哪些呢限制美聯社80均值	飛行
讓我知道從波士頓到丹佛的美聯航航班	縮寫
什麼是從拉瓜迪亞到紐約市中心的距離	飛行
什麼是最後一個航班從亞特蘭大到波士頓	距離
告訴我從丹佛飛往巴爾的摩抵達五月初五所有航班	飛行
什麼是最便宜的單程機票從亞特蘭大到丹佛留在十月十二	飛行
從列出的所有紐瓦克直飛航班坦帕離開上週五	機票
讓我對美國的航空公司從波士頓到加州奧克蘭其中上午11點離開後所有航班	飛行
找到從波士頓到奧克蘭最早的航班，供應早餐	飛行
告訴我從坦帕到ST航班。路易上午10點前離開	飛行
I'd想知道的從亞特蘭大頭等艙到舊金山的價格	飛行
我想從丹佛飛往匹茲堡的航班	機票
從達拉斯到巴爾的摩頭等艙票價請	飛行
是什麼從納什維爾飛往塔科馬並從納什維爾到聖何塞，未來兩天早晨航班	機票
我有兩個朋友，就是想點擊這裡查看我週三在華盛頓一個他們住在丹佛和邁阿密等生活	飛行
怎麼樣來港定居在美國亞特蘭大	飛行
亞特蘭大和舊金山之間飛行的航空公司是什麼	飛行
告訴我第十五從丹佛或離開達拉斯無論是在六月抵達巴爾的摩的航班	航空公司
我要飛從波士頓到達拉斯	飛行
地面交通費城	飛行
我需要從ST飛行。聖彼得堡邁阿密星期四	飛行
然後列出從亞特蘭大到費城星期三早上直飛航班	飛行
你可以列出丹佛租車的費用	飛行
什麼航空公司舊金山和丹佛之間飛	飛行
你可以列出ST之間的所有直達航班。聖彼得堡和夏洛特是假，下午5點以後很快到達	航空公司
現在我'd喜歡看到從底特律到ST航班。聖彼得堡在下星期二	飛行
從辛辛那提到達拉斯的航班718點以後出發	飛行
怎麼樣航班離開舊金山和波士頓抵達的任何一天	飛行
我想從華盛頓到費城TWA航班信息	飛行
沒關係，你可以告訴我，這讓達拉斯最早的航班從費城	飛行
是什麼限制美聯社55	飛行
什麼地面交通有在奧克蘭	縮寫
什麼才是從丹佛飛往匹茲堡最便宜的航班兩個單程和往返航班	飛行
你能告訴我什麼航班在12月16從奧克蘭前往達拉斯	飛行
如何從明尼阿波利斯去長灘明天晚	飛行
請告訴我早上8點之後，從匹茲堡飛往波士頓在週六上午航班	飛行
告訴我所有經濟價格從巴爾的摩到達拉斯	飛行
什麼航班都可以從達拉斯DL亞特蘭大在星期一早上	機票
我想從波士頓飛往巴爾的摩	飛行
是什麼從亞特蘭大到巴爾的摩晚上航班	飛行
我可以在達拉斯租車	飛行
是什麼從達拉斯到費城的航班	飛行
什麼才是最早的航班從亞特蘭大到波士頓	飛行
什麼是EWR	飛行
相信我'd像，以確定哪些飛機在七月初七從波士頓離開和抵達亞特蘭大上使用七月初七	縮寫
在大陸上週日從丹佛飛往芝加哥的航班	飛機
我需要從納什維爾飛往塔科馬第一件事就是在早上還有什麼	飛行
我需要從費城到丹佛航班	飛行
好吧，我'd喜歡在下午對我們飛行的空氣從印第安納波利斯到圣迭戈什麼才是可用	飛行
什麼是票價從巴爾的摩去波士頓的一種方式上月第七	飛行
是什麼從丹佛飛往舊金山的航班上週二十月十五	機票
什麼地面交通有從市中心亞特蘭大機場	飛行
從巴爾的摩丹佛和匹茲堡到費城，每個往返票價低於1000美元的航班	飛行
有一站與美國波士頓的空氣在705離開亞特蘭大	飛行
我感興趣的航班從丹佛飛往匹茲堡	飛行
什麼是從長灘到孟菲斯最便宜的航班	飛行
什麼地面交通可在巴爾的摩機場	飛行
我想飛行儘早在當天從波士頓和丹佛離開	飛行
告訴我從巴爾的摩飛往西雅圖的航班	飛行
列出起飛和降落在米切爾將軍國際	飛行
在紐約機場	飛行
什麼是從波士頓飛往達拉斯的最低票價	飛機場
，經過2點之前凌晨5時抵達星期二波士頓和費城之間的航班	機票
讓我從ST的航班。聖彼得堡到多倫多，在清晨到達	飛行
請列出從巴爾的摩到舊金山在週五的航班	飛行
從納什維爾回到密爾沃基的航班	飛行
I'd像從丹佛飛機一票亞特蘭大我想教練類或最低票價門票	飛行
請列出上午航班離開舊金山波士頓	機票
波士頓地面交通	飛行
什麼航班從芝加哥到西雅圖上週六美國大陸航空公司	飛行
需要多少費用，從達拉斯飛到三角洲巴爾的摩	飛行
告訴我從巴爾的摩飛往費城國際	機票
I'd喜歡洛杉磯的往返票塔科馬華盛頓	飛行
告訴我從波士頓離開匹茲堡7月24日第二到達航班	機票
我想從費城到達拉斯的航班上美國航空公司	飛行
我想從波士頓飛往美國聯合航空公司丹佛	飛行
在那裡有從波士頓飛往費城是630點以前留下任何航空公司	飛行
告訴我從匹茲堡飛往舊金山週一航班	航空公司
在波士頓機場和市區之間有地面交通	飛行
地面交通華盛頓	飛行
從波士頓到奧克蘭航班從波士頓徑直穿過奧克蘭，而不在其他城市停止美國飛行813	飛行
請列出從芝加哥到堪薩斯城的航班	飛行
確實丹佛和波士頓之間的航班??為DC10服務	飛行
什麼是波音767飛機的座位容量	航空公司
我想從堪薩斯城到ST旅行。保羅和在那裡通過晚餐	容量
列出所有從舊金山匹茲堡週一晚間抵達航班頭等艙	飛行
從休斯敦到密爾沃基的美國航空公司航班什麼上週五	飛行
我想預定一個航班從坦帕去西雅圖可以第二十六個我想停在密爾沃基的道路上	飛行
從拉斯維加斯到紐約請名單直飛航班TWA	飛行
什麼是航空公司FF	飛行
告訴我航班會從匹茲堡飛往舊金山週一	航空公司
告訴我所有從奧克蘭抵達丹佛的航班	飛行
告訴我所有的票價從塔科馬到蒙特利爾的一種方式	飛行
請列出從費城到丹佛機場的所有航班下週日成本	機票
I'd喜歡從波士頓前往巴爾的摩美國航空269請告訴我時間	機票
您好我想往返票達拉斯	飛行
我是計劃前往匹茲堡和我住在丹佛，你可以幫我	機票
該航空公司每天都有從波士頓飛往達拉斯的航班	飛行
讓我從舊金山到紐瓦克晚上11點以後離開航班	航空公司
清單航班上週六離開達拉斯和下午4點前到達舊金山	飛行
什麼是FF	飛行
告訴我，從亞特蘭大到費城的航班	縮寫
告訴我從印第安納波利斯飛往蒙特利爾的航班	飛行
什麼航班有上週日從西雅圖到芝加哥	飛行
顯示從ST的所有航班。聖彼得堡和夏洛特的航班應該離開中午下午5點以後直飛航班抵達後	飛行
什麼西北航班停在丹佛	飛行
請給我從匹茲堡飛往舊金山週一航班	飛行
告訴我從匹茲堡飛往費城國際	飛行
什麼地面交通距離匹茲堡市中心可用	飛行
告訴我航班從舊金山一流預訂匹茲堡星期一	縮寫
什麼早上9點之前型號的飛機葉子從波士頓到華盛頓特區	飛行
Delta飛往達拉斯請	飛機
顯示飛行從匹茲堡飛往舊金山的所有航空公司	飛行
在巴爾的摩有地面交通	航空公司
美國航空公司航班從華盛頓到費城信息	飛行
告訴我所有關於從巴爾的摩到達拉斯的飛行這是上市DL 1055 DL 405的信息	飛行
我需要一張票從丹佛去巴爾的摩頭等艙機票上聯合航空公司的成本	飛行
該直飛航班從亞特蘭大到下午奧克蘭葉和下午5時到達	機票
我需要從費城到波士頓的班機	飛行
什麼是在聖地亞哥的地面交通	飛行
告訴我從巴爾的摩飛往舊金山的所有航班	飛行
我想從費城飛往達拉斯航班	飛行
現在我需要一個單程航班從匹茲堡飛往丹佛	飛行
我想從匹茲堡到洛杉磯的航班下午6點，週四後離開	飛行
讓我從舊金山到波士頓的航班	飛行
多少頭等艙航班由美國航空公司提供	飛行
讓我知道從匹茲堡飛往達拉斯的航班	數量
什麼地面交通可在波士頓	飛行
在匹茲堡機場有豪華轎車服務	飛行
給我返回從費城飛往舊金山的航班十二月第三	飛行
讓我從拉斯維加斯到丹佛的最新航班	飛行
列出從印第安納波利斯到休斯敦的航班	飛行
是什麼，東方波士頓和華盛頓之間的最早的航班	飛行
給我堪薩斯城芝加哥離開下週三到達芝加哥的航班於晚上七時	飛行
沒事我'd喜歡做的就是找到從波士頓到丹佛最便宜的單程票價	飛行
告訴我從匹茲堡飛往巴爾的摩的航班在8月第三列表	機票
什麼航空公司的交流和	飛行
I'd喜歡看到從巴爾的摩到費城的航班	航空公司
多少從克里夫蘭到邁阿密一流的往返票對我們的空運費用是多少	飛行
什麼是所有的航班到亞特蘭大的機場	機票
告訴我從匹茲堡飛往費城週三早上航班	飛行
什麼才是最早的航班離開丹佛匹茲堡	飛行
告訴我，從亞特蘭大到北卡羅萊納州夏洛特留在週一和夏洛特到達航班	飛行
我想從邁阿密飛往芝加哥的美國航空公司，並在約下午5點抵達顯示我的所有航班	飛行
什麼從聖航班。路易聖。保羅在週四上午10點後離開	飛行
請列出從紐約到洛杉磯的航班	飛行
有沒有從丹佛飛往亞特蘭大匹茲堡任何航班	飛行
什麼頭等艙飛機從費城到舊金山去，並在達拉斯停止下午週一	飛行
顯示從丹佛飛往奧克蘭的航班	飛機
最低票價從印第安納波利斯飛往西雅圖	飛行
什麼才是從達拉斯到巴爾的摩十二月十七最便宜的航班	機票
告訴我從達拉斯到波士頓的航班	飛行
請給我從匹茲堡飛往亞特蘭大直接早上航班	飛行
顯示上月第二十九從巴爾的摩到達拉斯的所有航班	飛行
什麼是商務艙機票從波士頓前往達拉斯留下七月第一成本	飛行
讓我看看帶飯菜離開上週日芝加哥西雅圖大陸航班	機票
從匹茲堡到紐瓦克的航班	飛行
告訴我從巴爾的摩到波士頓的航班	飛行
我想預定在四月第六從佛羅里達州坦帕的早班飛機到北卡羅萊納州夏洛特	飛行
美國聯合航空公司提供從丹佛飛往巴爾的摩任何頭等艙機票	飛行
我想從亞特蘭大TWA航班飛往舊金山，在丹佛停留	飛行
我在尋找從夏洛特到拉斯維加斯的航班，在ST停止。路易斯希望晚餐飛行我如何才能找到了	飛行
丹佛到舊金山週三	飛行
從波士頓到華盛頓特區的所有航班	飛行
直飛航班西雅圖到堪薩斯城	飛行
有沒有到達拉斯的航班增量852一頓飯從舊金山	飛行
列出了從費城離開亞特蘭大週四早早上8點前航班	膳食
是什麼從波士頓到巴爾的摩明天就要走的航班	飛行
顯示波士頓和費城之間的所有美聯航航班	飛行
什麼是從匹茲堡到舊金山最早的航班	飛行
什麼航班之間有華盛頓和舊金山離開華盛頓6時後週三	飛行
從丹佛到亞特蘭大航班什麼	飛行
告訴我所有的多倫多nationair航班	飛行
列出從洛杉磯到匹茲堡所有的直飛航班，其下午5點在週二之前到達	飛行
I'd喜歡從哥倫布飛往納什維爾明天上午	飛行
我需要從匹茲堡在巴爾的摩抵達航班	飛行
紐約和邁阿密的商務艙票價之間的所有往返航班	飛行
找到從達拉斯往返航班匹茲堡晚上8點以後抵達的行程安排	飛行
給我從密爾沃基到菲尼克斯美航在週六和週日	飛行
什麼類型的地面交通費城可用	飛行
請告訴我從丹佛飛往波士頓的航班航空公司在費城短暫停留	飛行
像從舊金山到波士頓在週四上午航班信息	航空公司
費城到舊金山	飛行
可我從長灘加州俄亥俄州哥倫布市的航班上週三上市	飛行
告訴我在巴爾的摩抵達六月最便宜的航班第十四從達拉斯開始	飛行
找到從多倫多到聖地亞哥航班與加拿大航空在舊金山短暫停留	飛行
什麼是渦輪螺旋槳發動機後S上的下一個最小的飛機	飛行
告訴我什麼是票價代碼符號代表	飛機
什麼樣的地面交通有沒有在華盛頓特區	縮寫
列出所有往返票價從鳳凰城到華盛頓	飛行
什麼票價代碼覆蓋從費城飛往舊金山的航班	機票
從波士頓到華盛頓特區的所有航班十一月十一	縮寫
什麼樣的地面運輸在達拉斯可用	飛行
我需要從巴爾的摩到西雅圖航班	飛行
什麼呢共同均值	飛行
I'd喜歡從波士頓飛往舊金山，你可以找到我的最低票價	縮寫
我想從密爾沃基飛往奧蘭多	飛行
和什麼從納什維爾飛往塔科馬的航班十八再次	飛行
顯示從匹茲堡中午12時後抵達的航班到舊金山	飛行
什麼呢?平均	飛行
什麼是從巴爾的摩到舊金山去，並在舊金山到達下午8點在週五航班	縮寫
請告訴我所有從波士頓航班	飛行
在丹佛地面交通	飛行
從匹茲堡飛往舊金山頭等艙往返航班信息	飛機
找旅行社安排從波士頓的往返航班匹茲堡晚上8點後抵達	飛行
告訴我從波士頓到匹茲堡週三和週四的航班	飛行
不費城機場有一個名字	飛行
找到從多倫多到聖地亞哥達美航空公司航班使用臨時滯留在DC	飛機場
沒有美國航空公司飛從匹茲堡飛往亞特蘭大	飛行
American Airlines從鳳凰到密爾沃基	飛行
給我最便宜的單程票價從聖地亞哥飛往邁阿密	飛行
有沒有航班明天早上從哥倫布到納什維爾	機票
列出從奧克蘭每天飛往波士頓的航班使用聯合航空公司	飛行
亞特蘭大匹茲堡	飛行
告訴我，從亞特蘭大到華盛頓週四早上的航班	飛行
什麼是早上最早的航班從波士頓巴爾的摩抵達	飛行
我想從費城到舊金山的航班，但我想停在達拉斯	飛行
我需要從丹佛十人到圣迭戈在鳳凰短暫停留，請給我航班	飛行
I'd喜歡從丹佛飛往匹茲堡亞特蘭大你會發現我做這件事最便宜的方式	飛行
是否有任何更新的航班比810時從密爾沃基前往塔科馬明晚	飛行
我要飛從巴爾的摩到費城	飛行
什麼是最新的航班從舊金山到波士頓	飛行
我想從匹茲堡飛往亞特蘭大對我們的空氣	飛行
沒有美國航空公司飛往舊金山來自亞特蘭大	飛行
告訴我從巴爾的摩到亞特蘭大晚上航班	飛行
給我看在威徹斯特縣的地面交通	飛行
告訴我從巴爾的摩到波士頓的航班	機票
紐瓦克到明尼阿波利斯在星期天	飛行
從巴爾的摩到費城的航班，其中往返票價低於1000美元	飛行
告訴我往返票價從匹茲堡飛往費城	飛行
可以請你告訴我，從匹茲堡飛往波士頓下週的週三中午之前到達的航班	機票
列出的從波士頓到費城中途航空公司航班票價	飛行
找我從亞特蘭大最新飛回波士頓在同一天	機票
我想從巴爾的摩飛往舊金山東航	飛行
請列出波士頓和費城週日操作之間的所有航班	飛行
顯示紐約市和拉斯維加斯之間的航班??我	飛行
什麼才是從巴爾的摩到達拉斯在美國最便宜的航班	飛行
並中西部快捷服務巴爾的摩	飛行
I'd想知道在沃思堡提供的地面交通	飛行
告訴我，中西部快捷服務於所有城市	飛行
你能告訴我離開匹茲堡子夜時分奧克蘭航班	市
什麼航班從坦帕到辛辛那提	飛行
告訴我匹茲堡頭等艙航班從舊金山回事中午12點以後離開的星期一	飛行
什麼呢MCO平均	飛行
從波士頓飛往華盛頓的航班信息	縮寫
告訴我在鹽湖城機場的地面交通	飛行
請列出從加州奧克蘭到費城週三所有可用的航班	飛行
請告訴我從費城到丹佛週日航班所有航空公司	飛行
請告訴我從丹佛飛往奧克蘭是直飛所有航班	航空公司
我想從機場到拉斯維加斯知道類型的地面交通	飛行
什麼是最便宜的單程票價從匹茲堡飛往亞特蘭大旅行週二八月二十	飛機
I'd喜歡再看到從匹茲堡飛往費城的所有航班	機票
我想從達拉斯首飛到休斯敦3月首次從休斯頓回到達拉斯在3月最後一個飛行第一	飛行
請告訴我從匹茲堡到亞特蘭大在平日可用航班	飛行
讓我從聖何塞飛往匹茲堡的最早的航班，供應小吃	飛行
什麼是克利夫蘭最廉價的頭等艙票價邁阿密的美國二月廿四空氣	飛行
從波士頓去什麼航班匹茲堡1205後，下午	機票
有多少航空公司由密爾沃基的方式，從紐約飛到洛杉磯	飛行
什麼是票價代碼FN	數量
從華盛頓到亞特蘭大	縮寫
什麼是最早的早上的航班離開波士頓華盛頓	飛行
什麼航班有從紐瓦克飛往西雅圖星期六	飛行
什麼航班有亞特蘭大和丹佛之間	飛行
是什麼從匹茲堡到奧克蘭航班	飛行
我想從丹佛前往匹茲堡	飛行
從匹茲堡飛往費城的所有航班	飛行
尋找從多倫多到聖地亞哥航班	飛行
你有沒有從亞特蘭大直飛巴爾的摩的航班是波音757抵達巴爾的摩晚上7點左右	飛行
該航空公司通過其他城市從波士頓飛往華盛頓	飛行
什麼是亞特蘭大和舊金山之間的最低票價	航空公司
請告訴我從紐約到邁阿密的所有往返航班	機票
從機場到波士頓的波士頓市區地面交通	飛行
什麼是上週四中午前從服務波士頓一頓飯飛往匹茲堡的航班票價	飛行
列出所有在米切爾將軍國際的起飛和著陸	機票
我想從丹佛飛往匹茲堡可能最便宜的航班	飛行
讓我在六月十四巴爾的摩抵達航班	飛行
列出週三的所有航班會從波士頓到亞特蘭大下午6點後	飛行
顯示我的所有航班TWA請	飛行
顯示來自孟菲斯拉斯維加斯的航班	飛行
是什麼代碼YN意思	飛行
什麼航班上有大陸從西雅圖到芝加哥	縮寫
什麼是最便宜的單程航班從亞特蘭大到波士頓	飛行
告訴我從波士頓到舊金山，當天下午抵達航班	飛行
並中西部快捷服務蒙特利爾	飛行
什麼是丹佛和波士頓之間的最低票價	飛行
我需要去匹茲堡和丹佛	機票
現在我想看到從邁阿密到紐約的回程航班	飛行
美國航空出港航班從夏洛特下午1點左右	飛行
什麼才是最早的航班，我可以波士頓和達拉斯之間得到	飛行
什麼是來自華盛頓的節儉經濟的航班票價舊金山	飛行
我想從機場到市區的亞特蘭大地面交通信息在上午9點左右，早上	機票
可我從俄亥俄州哥倫布市的航班號明尼阿波利斯明尼蘇達週一上市	飛行
我感興趣的二月第二十二預訂從達拉斯的早班飛機到休斯頓，並在深夜返回二月第二十二	航班號
告訴我地為達拉斯交通	飛行
什麼航空公司從波士頓飛往華盛頓	飛行
告訴我從波士頓飛往丹佛的航班	航空公司
讓我看看波士頓和多倫多之間的航空公司	飛行
顯示從亞特蘭大到費城我早上航班	航空公司
是什麼從丹佛飛往匹茲堡的特價機票，即停止在亞特蘭大	飛行
有多少城市是由大陸提供一流的航班	飛行
讓我從舊金山到丹佛的最新航班	數量
告訴我所有從印第安納波利斯飛往蒙特利爾的航班	飛行
什麼'再從紐約到邁阿密的特價機票	飛行
告訴我從丹佛飛往華盛頓的航班星期三	飛行
是什麼從華盛頓飛往丹佛的航班	飛行
顯示我的所有航班都直接和連接到無論是舊金山或奧克蘭從波士頓是下午2點之前到達	飛行
I'd喜歡從拉斯維加斯到底特律的航班上週一	飛行
巴爾的摩費城星期三	飛行
你可以列出從波士頓飛往華盛頓與上週六離開了最低的國家之一單程票價	飛行
什麼航班從舊金山到丹佛星期一	飛行
匹茲堡丹佛	飛行
留下丹佛飛往舊金山上午10點用途是什麼飛機的類型之前，	飛行
沒有增量達拉斯有什麼飛往丹佛的5點後	飛機
你有沒有從匹茲堡到任何亞特蘭大直達航班	飛行
列出每天從丹佛飛往波士頓的航班	飛行
是什麼從丹佛飛往匹茲堡的航班	飛行
該航班抵達聖。路易斯從聖。保羅在週四上午	飛行
從達拉斯沃斯堡機場機場多遠是達拉斯	飛行
什麼航班都可以從週五費城到奧克蘭	距離
告訴我上午11點前從波士頓八月第二丹佛的三角洲航班	飛行
從匹茲堡飛往巴爾的摩上午10點到下午2點之間的航班	飛行
是什麼從波士頓到舊金山航班	飛行
什麼地面交通可從匹茲堡機場到市區和需要多少費用	飛行
列出所有航班從波士頓到亞特蘭大去早上7點在週四之前	飛行
確實DL立場三角洲	飛行
告訴我從波士頓飛往匹茲堡的航班	縮寫
沒關係什麼航班有我們從奧蘭多飛往克利夫蘭的空氣留在下午	飛行
八月三十我想從丹佛到舊金山在早期上午航班	飛行
我希望看到從丹佛飛往亞特蘭大的特價機票	飛行
什麼是你已經離開波士頓標題費城最早的航班	飛行
我住在華盛頓，我想作出了一趟舊金山，你能告訴我哪個航空公司與這兩個城市連接	飛行
從亞特蘭大飛往舊金山八月第二個航班	飛行
我想從費城到達拉斯的飛行，使得在亞特蘭大站	飛行
從紐瓦克飛往波士頓的航班	飛行
從波士頓到亞特蘭大的航班什麼	飛行
列出所有航班從華盛頓取悅於舊金山	飛行
我想看到週一從匹茲堡飛往舊金山的航班	飛行
什麼是週四上午從亞特蘭大到丹佛首飛票價	飛行
請告訴我航空公司與波士頓與停在費城來自丹佛的航班	機票
多少航班UA 270從丹佛飛往費城成本	航空公司
尋找從克里夫蘭到達拉斯航班	機票
我需要從巴爾的摩到舊金山預訂	飛行
從菲尼克斯到拉斯維加斯的航班	飛行
有多少是往返票價從納什維爾飛往西雅圖	飛行
列出波士頓和使用奧克蘭德爾塔航空公司之間的所有的每日航班	機票
有多少是亞特蘭大和市區之間的地面交通	飛行
是什麼YN代表	飛行
什麼才是一個733的能力	縮寫
什麼樣的飛機從波士頓去舊金山中午前	容量
從巴爾的摩在1000元往返車費費城	飛機
什麼是MCO	機票
是什麼從丹佛飛往舊金山的航班下午	縮寫
什麼從紐瓦克飛往洛杉磯週三	飛行
顯示從紐約到邁阿密在週二，其售價低於466美元的單程直飛航班	飛行
從蒙特利爾飛往拉斯維加斯的航班和鳳凰	飛行
給我密爾沃基最新的西北航空公司的航班飛往塔科馬的明天	飛行
哪些航班可以從波士頓到亞特蘭大七月初七上午8點	飛行
請列出從哥倫布最早的午餐飛往鳳凰城	飛行
你有從亞特蘭大到波士頓的航班	飛行
告訴我，從圣迭戈到紐瓦克在休斯敦一站式的航班	飛行
週一告訴我從巴爾的摩到達拉斯的航班	飛行
告訴我從華盛頓到波士頓的航班星期五	飛行
告訴我從波士頓到匹茲堡週三航班	飛行
告訴我最低的價格從達拉斯到巴爾的摩	飛行
地面交通ATL亞特蘭大	飛行
顯示九月十七丹佛和舊金山之間的航班	飛行
什麼地面交通有在達拉斯	飛行
我想從費城飛往達拉斯，在亞特蘭大的停在早餐飛行	飛行
從丹佛到舊金山的航班上週三，我和'M請求航班信息	飛行
什麼航空公司有從波士頓飛往費城是630點以前離開	飛行
告訴我從達拉斯到亞特蘭大的航班	航空公司
請告訴我從印第安納波利斯的孟菲斯單程頭等艙機票	飛行
請給丹佛機場的地面交通	飛行
其中西北，美聯航航班辦理丹佛中午前	飛行
什麼是HP	飛行
列出所有航班會從波士頓到亞特蘭大上午07點在週四之前	縮寫
什麼是舊金山機場與城市之間的地面交通	飛行
什麼航班還有今天上午從亞特蘭大到費城	飛行
讓我從所有機場愛情領域的航班	飛行
從哥倫布到密爾沃基航班	飛行
給我匹茲堡和巴爾的摩之間的航班??列表	飛行
告訴我在華盛頓特區的所有地面交通	飛行
我需要從多倫多到聖地亞哥航班與加拿大航空在華盛頓短暫停留	飛行
讓我在週三的最新航班從亞特蘭大到華盛頓特區	飛行
有多遠距離匹茲堡市中心的機場	飛行
請給我從亞特蘭大飛往波士頓的航班在週三和週四	距離
波士頓丹佛週一	飛行
是的，我想查找航班從亞特蘭大到波士頓七月初七上午	飛行
列出從舊金山到波士頓團結所有航班	飛行
什麼航班你有從紐瓦克新澤西加州安大略省，在鳳凰連接	飛行
告訴我從巴爾的摩飛往費城國際	飛行
什麼是票價代碼QX和QW的意義	飛行
讓我看看波士頓和匹茲堡之間的每日航班時刻表	縮寫
讓我從威徹斯特縣到辛辛那提的航班	飛行
讓我在九月三十航班從舊金山離開丹佛	飛行
什麼航空公司從多倫多飛往聖地亞哥	飛行
告訴我從達拉斯到巴爾的摩航班	航空公司
匹茲堡波士頓週六	飛行
什麼是從波士頓首飛到斯特普爾頓明天機場	飛行
什麼美國聯合航空公司航班經過丹佛	飛行
費城到波士頓週一	飛行
列出亞特蘭大和達拉斯之間的晨航	飛行
我試圖從丹佛飛往波士頓，我想，供應一餐飛行	飛行
什麼密爾沃基飛往聖何塞的航班上週三美國航空公司	飛行
讓我知道從伯班克到丹佛的航班	飛行
告訴我從辛辛那提飛往丹佛的航班	飛行
從DC到丹佛的航班	飛行
告訴我從亞特蘭大到華盛頓特區的所有航班的價格	飛行
汽車租賃在巴爾的摩	機票
I'd喜歡看到從亞特蘭大到華盛頓的航班	機票
顯示從匹茲堡飛往舊金山八月第二的所有航班	飛行
是什麼在八月十匹茲堡和巴爾的摩之間的航班	飛行
我想去從丹佛飛往奧克蘭	飛行
什麼時候離開從丹佛飛往匹茲堡七月初七的航班	飛行
什麼才是從丹佛飛往匹茲堡最廉價的單程航班	飛行時間
告訴我從達拉斯到巴爾的摩航班	飛行
告訴我，從亞特蘭大到波士頓的美國空中航班	飛行
告訴我從匹茲堡飛往舊金山的所有航班	飛行
告訴我從舊金山到波士頓的航班列表	飛行
告訴我從波士頓到舊金山最早的航班	飛行
什麼才是從聖何塞到休斯敦的最新航班	飛行
什麼從邁阿密飛往印第安納波利斯航班	飛行
該航班波士頓和匹茲堡之間飛	飛行
航班從納什維爾飛往克里夫蘭	航空公司
給我從紐瓦克飛往坦帕航班上週五	飛行
並中西部快捷服務費城	飛行
告訴我從丹佛飛往舊金山的航班	飛行
我想從華盛頓到波士頓的航班324八月二十一個航班	飛行
告訴我從達拉斯到休斯敦直飛航班	飛行
什麼是波士頓和舊金山之間最便宜的商務艙航班	飛行
有沒有離開費城2點左右，下午費城和丹佛之間的航班	飛行
列出從達拉斯到巴爾的摩航班	飛行
告訴我成本和時間從舊金山到亞特蘭大的航班	飛行
什麼是票價碼Y平均值	飛行
我想看到從丹佛飛往費城的航班	縮寫
有亞特蘭大飛往丹佛的航班連接	飛行
什麼是最後一個航班從匹茲堡到波士頓在晚上星期二	飛行
是什麼從丹佛飛往舊金山的所有週一航班聯合航空公司	飛行
顯示從匹茲堡飛往舊金山的航班都在七月第二十八1991	飛行
我想從舊金山到匹茲堡之前8點週二上午航班的任何匹茲堡到達信息	飛行
我想看到從丹佛飛往費城的航班	飛行
該航空公司擁有最商務艙航班	飛行
找旅行社安排從達拉斯往返航班匹茲堡晚上8點以後	航空公司
美國聯合航空公司從丹佛飛往巴爾的摩	飛行
你能告訴我從巴爾的摩到達拉斯的航班	飛行
告訴我所有的增量航班離開或在12日下午和4之間在抵達匹茲堡	飛行
什麼航空公司除了波士頓和丹佛之間的歐陸蒼蠅	飛行
告訴我所有的上午10點前抵達匹茲堡的航班直接從波士頓到匹茲堡連接	航空公司
有沒有航班離開華盛頓3點鐘左右丹佛	飛行
我想從丹佛飛往舊金山週二航班時間表	飛行
我可以租一輛車在聖何塞太	飛行時間
什麼才是從達拉斯到休斯敦最早的航班	飛行
我想從費城到加利福尼亞州奧克蘭星期五下午航班信息	飛行
什麼樣的飛機類型之前中午12時許從亞特蘭大到費城飛行中使用	飛行
什麼航空公司DL	飛機
讓我從舊金山到波士頓費城或巴爾的摩的所有航班	航空公司
是什麼從舊金山到匹茲堡早期平日航班	飛行
亞特蘭大奧克蘭週四	飛行
我想從安大略省到芝加哥航班	飛行
列出從明尼阿波利斯到長的海灘上週六的所有航班	飛行
我想從波士頓飛往丹佛費城停止	飛行
我需要從ST下午航班列表。聖路易斯到芝加哥	飛行
從波士頓到奧蘭多航班什麼	飛行
列出週三所有航班從波士頓前往亞特蘭大週三下午6點後	飛行
沒有增量從丹佛有什麼航班到達拉斯後5	飛行
I'd喜歡從波士頓到舊金山	飛行
告訴我到費城從巴爾的摩或丹佛或匹茲堡未來航班	飛行
讓我知道從舊金山到波士頓月第三十一個1991年的航班	飛行
什麼航班從芝加哥到西雅圖的美國大陸航空公司週六	飛行
飛行價格從克里夫蘭到納什維爾	飛行
上週五紐瓦克出發航班什麼坦帕	機票
什麼是從匹茲堡飛往丹佛的最便宜的航班	飛行
上月第四我就會從匹茲堡前往亞特蘭大，你能告訴我是什麼飛行將是最便宜的	飛行
列出在米切爾將軍國際所有航班抵達	飛行
顯示我的所有經濟價格從達拉斯到巴爾的摩	飛行
告訴我奧蘭多國際和奧蘭多之間的地面交通	機票
從舊金山到丹佛平日航班	飛行
給我的波士頓和費城之間的最便宜的一種方式，其航班中午在週二抵達後	飛行
告訴我從波士頓飛往匹茲堡下週三晚上的航班後，6點	飛行
告訴我從費城到巴爾的摩的所有航班	飛行
告訴我從波士頓到丹佛週三6之前到達其在丹佛的所有航班	飛行
我想一個航班，上週五從費城飛往達拉斯的葉子，使得在亞特蘭大站	飛行
鳳凰紐瓦克週三	飛行
地面交通為ST。保羅	飛行
找我從波士頓到亞特蘭大最早的航班從亞特蘭大到波士頓在當天最新的回報	飛行
什麼是票價代碼H	飛行
什麼是一頓碼S的含義	縮寫
是什麼票價代碼QX意思	縮寫
有多少票價從塔科馬到蒙特利爾有一個辦法	縮寫
沒有大陸航空公司飛往匹茲堡亞特蘭大	數量
所有達拉斯往返航班和票價從亞特蘭大12點後不到1100元	飛行
什麼類型的飛機離開費城達拉斯	航班機票+
什麼航班都可以從舊金山週日匹茲堡	飛機
是否有增量航班離開丹佛	飛行
在亞特蘭大請名單地面交通	飛行
我想從匹茲堡飛往舊金山	飛行
我期待從匹茲堡到舊金山的航班	飛行
在列出離開大陸丹佛所有航班	飛行
我想從亞特蘭大飛往波士頓波士頓到達下午5點	飛行
你有沒有從波士頓到沃斯堡飛行	飛行
告訴我從丹佛飛往巴爾的摩的美國聯合航空公司的航班離開六月十四	飛行
讓我從舊金山飛往西雅圖的航班	飛行
什麼航班有星期三下午6時後華盛頓和舊金山之間	飛行
發現離開費城和抵達達拉斯中午的航班	飛行
從巴爾的摩到費城的航班信息	飛行
是什麼限制美聯社57	飛行
我需要的信息您的幫助對地面交通從市中心在費城機場	縮寫
請列出波士頓和舊金山之間的直飛航班全部	飛行
波士頓和費城之間的最昂貴的飛行	飛行
並中西部快捷必須從蒙特利爾飛往底特律航班的任何	飛行
列出所有從丹佛飛往費城國際	飛行
找到從舊金山到達拉斯單程飛行行程安排	飛行
什麼是票價代碼C	飛行
從安大略飛往奧蘭多說的出發抵達前9小時	縮寫
從美國辛辛那提飛往休斯敦霍比	飛行
告訴我從密爾沃基到奧蘭多單程航班	飛行
我想從丹佛飛往匹茲堡的航班	飛行
在12月份有沒有從亞特蘭大到丹佛的任何航班。該停在波士頓	飛行
什麼是舊金山和市中心之間的可用地面交通	飛行
我需要從印第安納波利斯飛往休斯頓TWA	飛行
從安大略省到佛羅里達州的航班	飛行
好吧，我已經得到別人誰願意承擔往返票從夏洛特飛往蒙特利爾	飛行
航班從克利夫蘭飛往納什維爾	機票
如何從丹佛機場到市區得	飛行
什麼航空公司使用代碼馬力	飛行
請告訴我從波士頓到丹佛停止費城往返航班的航空公司	航空公司
告訴我從巴爾的摩飛往匹茲堡的航班	航空公司
該航空公司有夏洛特和紐瓦克之間的航班	飛行
有沒有在亞特蘭大機場的機場豪華轎車	航空公司
告訴我航班週一晚上8點為達拉斯到波士頓後	飛行
什麼是在波士頓可用的地面交通	飛行
讓我從多倫多早上航班	飛行
什麼是機票從匹茲堡飛往亞特蘭大	飛行
清單航班從匹茲堡飛往巴爾的摩	機票
我想達拉斯飛往舊金山週一七月十八	飛行
鳳凰丹佛	飛行
我感興趣的預訂從達拉斯的早班飛機到休斯頓，並在深夜返回	飛行
告訴我從達拉斯到巴爾的摩在經濟發展水平的航班	飛行
什麼航空公司從華盛頓離開	飛行
列出中午前從波士頓在達拉斯到達的航班數量	航空公司
我需要下午4時從達拉斯飛往舊金山，在舊金山	航班號
告訴我國際加拿大國際航空服務的城市	飛行
請列出從達拉斯的特價機票，巴爾的摩5月到達第七	市
什麼航班有從匹茲堡到達拉斯在週三上午	飛行
有多少航班就美國航空公司具有一類服務代碼的F	飛行
顯示航班達拉斯和費城之間的美國航空公司頭等艙	數量
十一月十三亞特蘭大何去何從飛往丹佛的航班上達美航空公司	飛行
解釋票價碼Q	飛行
我想之間匹茲堡和費城留在下午和下午5點附近到達的直飛航班	縮寫
有多少航班確實TWA與商務艙	飛行
告訴我週四上午的航班從亞特蘭大前往華盛頓特區	數量
有多少城市是由東部送達一流航班	飛行
告訴我從巴爾的摩到奧克蘭航班	數量
有多少城市是由美國航空公司提供一流的航班	飛行
什麼是在達拉斯的汽車租賃率	數量
什麼是在沃思堡提供的地面交通	機票
什麼是MIA	飛行
大約從波士頓到洛杉磯的航班是什麼	縮寫
地面交通巴爾的摩	飛行
而不是丹佛我可以有來自多倫多的同一個航班到聖地亞哥，但在停止達拉斯 - 沃斯堡	飛行
是什麼從奧蘭多飛往克利夫蘭的是晚上10點左右抵達的航班上美國空氣	飛行
再次我要重複我想打從波士頓單程航班亞特蘭大，你會告訴我多少錢的車費是我想的最低票價	飛行
從巴爾的摩在1000元往返車費費城	航班機票+
I'd喜歡看到從巴爾的摩到亞特蘭大是在中午之前到達航班	機票
有來自巴爾的摩團結飛往舊金山八月第二十七個上午	飛行
什麼是國際加拿大航空公司的英文縮寫	飛行
什麼航班離開匹茲堡下午5點後，週四抵達洛杉磯	縮寫
I'd喜歡多倫多航班從明天聖地亞哥	飛行
什麼航空公司飛入鹽湖城	飛行
我需要從波士頓到丹佛航班	航空公司
請求航班信息從波士頓飛往巴爾的摩週二	飛行
告訴我從亞特蘭大飛往華盛頓的航班，請	飛行
什麼航班，從華盛頓到多倫多	飛行
大約從波士頓到舊金山停止飛行在丹佛什麼	飛行
讓我從圣迭戈到紐瓦克新澤西州的航班	飛行
告訴我從巴爾的摩到達拉斯的最低票價	飛行
告訴我從達拉斯飛往匹茲堡的航班	機票
什麼是最便宜的票價為下午3點之後，從紐瓦克飛往洛杉磯留下週三航班	飛行
你有一個747，從舊金山飛往巴爾的摩	機票
讓我從蒙特利爾的所有航班	飛行
飛機的列表類型的匹茲堡和巴爾的摩之間飛	飛行
在那裡費城和丹佛之間的任何航班	飛機
列車到紐瓦克	飛行
從列出ST最早的航班。保羅·休斯頓	飛行
I'd喜歡從波士頓飛往舊金山	飛行
讓我在做從費城預約丹佛週日的一些信息	飛行
列出從波士頓到舊金山聯合國所有航班票價與QX代碼	飛行
離開從波士頓飛往亞特蘭大離開波士頓大約下午1點	飛行
I'd喜歡從波士頓到亞特蘭大最便宜的單程票價，請	飛行
給我從丹佛巴爾的摩抵達航班	機票
什麼時候從費城到丹佛飛大陸星期日	飛行
從什麼費城亞特蘭大的航班	飛行時間
什麼呢DFW平均	飛行
什麼時間是從巴爾的摩到舊金山航班	縮寫
什麼航班都可以明天從丹佛飛往費城	飛行時間
什麼是SA	飛行
告訴我從達拉斯到亞特蘭大的航班	縮寫
告訴我從丹佛飛往舊金山下週三中午該離開後，所有航班	飛行
我想波士頓和亞特蘭大之間的航線上，在一個下午七月11出發	飛行
列出所有離開丹佛大陸上週日航班	飛行
告訴我從巴爾的摩飛往費城國際	飛行
告訴我從丹佛飛往費城國際	飛行
從波士頓機場波士頓市中心有地面交通	飛行
請列出所有留在週四早上從紐約市到多倫多航班	飛行
請列出從達拉斯到巴爾的摩最便宜的航班抵達五七	飛行
請列出航班起飛和降落在米切爾將軍國際機場	飛行
我需要七月初七從丹佛飛往匹茲堡的航班葉色下午	飛行
我是從波士頓前往亞特蘭大和I'd喜歡去某個下午5點以後，但我想知道什麼樣的飛機它的上	飛行
告訴我從費城到巴爾的摩早上航班	飛機
讓我從舊金山到波士頓的特價機票	飛行
告訴我第一達拉斯地面交通信息	飛行
什麼樣的價格是豪華轎車服務於紐約的拉瓜迪亞	飛行
什麼航班離開拉瓜迪亞聖何塞和到達10點	飛行
什麼是對F28的座位容量	飛行
我需要的票價信息從丹佛飛往匹茲堡	容量
請告訴我家航空公司從波士頓飛往丹佛的航班	機票
哪些航班可以從匹茲堡飛往波士頓下週的週三	航空公司
你能告訴我從巴爾的摩到達拉斯的經濟艙票價航班	飛行
從匹茲堡頭等艙往返舊金山信息	機票
我想看到匹茲堡經濟票價費城	飛行
是什麼從拉斯維加斯到伯班克的航班上週六可22	機票
在列出大陸從丹佛飛往芝加哥934點之後，離開所有航班	飛行
告訴我在週三飛往華盛頓的航班丹佛	飛行
列出從波士頓到舊金山所有航班超過3級	飛行
什麼是美國聯合航空公司415航班從芝加哥到堪薩斯城星期四晚上成本	飛行
請給我的飛行時間在上午聯合航空公司的從費城九月二十舊金山	機票
上週六從芝加哥到西雅圖的美國大陸航空公司	飛行時間
我想從波士頓到舊金山的航班上八月十七	飛行
什麼堪薩斯城芝加哥下週三航班在芝加哥晚上約七時到達	飛行
給我從費城到丹佛的航班上週日	飛行
從SFO長灘所有航班	飛行
告訴我從匹茲堡到洛杉磯週四晚上航班	飛行
尋找飛往鹽湖城	飛行
請列出所有從費城飛往波士頓的航班	飛行
什麼是從費城最早早餐飛行沃思堡	飛行
什麼是飛機類型以最大的座位容量	飛行
我想知道是什麼飛機的類型將在七月初七從亞特蘭大到波士頓上午使用	飛機
讓我知道從丹佛飛往拉斯維加斯的航班	飛機
列出週二所有的直飛航班中午從夏洛特到巴爾的摩之前	飛行
從匹茲堡飛往費城美國空氣	飛行
我希望有一個航班是葉週四晚上7點左右從芝加哥到堪薩斯城	飛行
什麼類型的飛機是M80	飛行
告訴我從巴爾的摩到亞特蘭大的航班	飛機
還告訴我所有從奧克蘭飛往丹佛的航班	飛行
什麼“先上月■從亞特蘭大飛往波士頓的航班時間表	飛行
給我從亞特蘭大到波士頓早上航班列表	飛行時間
請列出從丹佛飛往鳳凰城的航班	飛行
告訴我價格和時間從巴爾的摩頭等艙達拉斯明年夏天	飛行
顯示從密爾沃基到奧蘭多航班上週四上午	機票
給我上週日孟菲斯和拉斯維加斯之間的航班	飛行
什麼是從亞特蘭大到巴爾的摩上午航班成本	飛行
什麼航空公司有	機票
什麼航班離開舊金山在週一晚上和晚上後來在抵達亞特蘭大	航空公司
告訴我從丹佛飛往波士頓的最後一次飛行	飛行
你能告訴我，下午直飛航班出發從亞特蘭大到波士頓	飛行
告訴我從坦帕到ST單程航班。路易上午10點前出發	飛行
告訴我從丹佛飛往巴爾的摩頭等艙航班	飛行
從丹佛到舊金山的航班什麼	飛行
什麼是從波士頓主帥經濟艙夜間服務舊金山	飛行
該航班從費城到舊金山	飛行
什麼是美國聯合航空公司於九月二十早上的航班	飛行
我想舊金山TWA航班從波士頓	飛行
請告訴我，從費城到巴爾的摩上午10點到下午2點之間的航班	飛行
還告訴我，從亞特蘭大到丹佛首次飛行在一個星期四	飛行
什麼是最早的航班，我可以從BWI到波士頓洛根得到	飛行
現在我需要從底特律到聖地亞哥起飛的航班星期二晚上	飛行
早餐是在飛行服UA 343從波士頓到丹佛主教練下課	飛行
列出從夏洛特到孟菲斯最便宜的航班	飛行
你可以列出從奧克蘭到鹽湖城週三的最新航班	飛行
我想舊金山大陸航班從波士頓	飛行
I'd喜歡從波士頓到舊金山匹茲堡停止	飛行
找到從波士頓到奧克蘭最早早餐飛行	飛行
什麼是三角形的總進度的所有航班的機場	飛行
什麼是8日前從波士頓飛往亞特蘭大最便宜的航班	飛行時間
讓我在週四從亞特蘭大到華盛頓最早的航班	飛行
什麼是達拉斯最昂貴的航班飛往巴爾的摩	飛行
有從匹茲堡到巴爾的摩飛行即6和7點之間到達	飛行
什麼是從波士頓到華盛頓最早的航班	飛行
什麼是教練的票價從夏洛特到紐瓦克週二晚間航班	飛行
什麼是在丹佛機場的名稱	機票
什麼才是從亞特蘭大到巴爾的摩最便宜的航班	飛機場
給我從亞特蘭大巴爾的摩抵達航班	飛行
從達拉斯飛往加利福尼亞州的奧克蘭週一	飛行
如何昂貴是舊金山豪華轎車服務	飛行
我想從達拉斯到丹佛最便宜的單程票價	飛行
列出聖何塞和休斯敦之間的航班	機票
什麼航班從堪薩斯城到丹佛	飛行
讓我從達拉斯飛往巴爾的摩成本低於300美元	飛行
多少航班UA 281從波士頓到丹佛成本	機票
告訴我從亞特蘭大到巴爾的摩航班	機票
什麼呢寬鬆立場	飛行
從聖何塞到休斯敦下週日航班列表	縮寫
告訴我從邁阿密到紐約最便宜的航班上提供一流的票價星期日	飛行
在拉斯維加斯的地面交通	飛行
讓我從舊金山飛往丹佛的航班	飛行
什麼是從波士頓到丹佛最早的航班	飛行
我想從芝加哥的早班飛機到大陸航空公司西雅圖	飛行
給我從坦帕到夏洛特的航班上週日	飛行
是什麼NW代表	飛行
告訴我從波士頓到匹茲堡週三或週四的航班	縮寫
我需要從匹茲堡飛往奧克蘭和離開下午	飛行
我想從亞特蘭大飛往華盛頓是下午3點後葉	飛行
在離開達拉斯的航班波士頓抵達達拉斯留在清晨，我需要的信息	飛行
奧克蘭和舊金山之間的航班??列表	飛行
告訴我從底特律飛往威徹斯特縣的航班單程	飛行
ST之間的飛行。聖彼得堡和夏洛特	飛行
讓我從巴爾的摩丹佛匹茲堡或在費城到達所有航班	飛行
我需要從亞特蘭大機場的地面交通信息	飛行
告訴我從波士頓到費城的航班	飛行
我想時間從華盛頓到費城你的最早的航班	飛行
從奧克蘭飛往舊金山的航班上月二十一1992年	飛行時間
什麼是從亞特蘭大到匹茲堡的最便宜的單程票價	飛行
讓我知道，在巴爾的摩晚上到達航班	飛行
是什麼從波士頓到丹佛的航班上週二十月十五	飛行
哪些呢票價碼Y平均值	飛行
我想從波士頓飛往舊金山	縮寫
我想從紐約到拉斯維加斯直飛航班三月第二	飛行
什麼是費城豪華轎車服務的成本	飛行
像我'd從波士頓飛到往返於匹茲堡	飛行
顯示我的一切，去從巴爾的摩飛往西雅圖的航班	飛行
I'd喜歡在早上華盛頓首次飛行從波士頓	飛行
是如何遠離鹽湖城機場鹽湖城	飛行
什麼是航空公司NW	距離
什麼是DL	航空公司
告訴我從亞特蘭大到丹佛其中下午5點後天離開後，所有航班	縮寫
你能告訴我航班華盛頓的價格從亞特蘭大週四上午	飛行
請告訴我從邁阿密到紐約的回程航班	機票
什麼是從多倫多抵達蒙特利爾週五首飛	飛行
什麼是費城和波士頓之間的最便宜的單程票價	飛行
是什麼從巴爾的摩到達拉斯在週日晚上的航班	機票
可我從明尼阿波利斯長灘加州的航班上週二上市	飛行
什麼從聖航班。保羅堪薩斯城上週五午餐服務	飛行
我想從華盛頓飛往舊金山	飛行
我需要從長灘到ST飛行。路易斯在達拉斯停止飛行也應該成為午餐	飛行
多長時間才能讓從丹佛飛往奧克蘭	飛行
什麼是亞特蘭大車費波士頓教練的一種方式	距離
讓我從舊金山到波士頓費城或巴爾的摩的所有航班	機票
該航班將在巴爾的摩到達拉斯在星期一下午有經濟類	飛行
從亞特蘭大到波士頓航班列表在週三下午和週四上午	飛行
什麼是最小的飛機可從匹茲堡飛巴爾的摩	飛行
什麼航空公司EA	飛機
什麼是達拉斯的最後一個航班到波士頓在晚上	航空公司
我想在華盛頓和舊金山之間的航班??信息在達拉斯停留	飛行
什麼是票價代碼F	飛行
告訴我到達從其他機場愛情領域的航班	縮寫
我需要從洛根到亞特蘭大的航班今天下午	飛行
從奧克蘭到費城週五航班	飛行
什麼是從舊金山國際機場到舊金山的距離	飛行
告訴我航班從亞特蘭大離開，去北卡羅萊納州夏洛特下週一我需要知道關於415和530點之間到達夏洛特的航班	距離
I'd喜歡波士頓和舊金山之間飛行	飛行
什麼從亞特蘭大到多倫多的航班	飛行
I'd喜歡從波士頓到舊金山，達拉斯停止	飛行
讓我從聖地亞哥飛往邁阿密的所有航班在丹佛停止	飛行
I'米從波士頓飛往隔艙區	飛行
顯示從丹佛飛往舊金山的所有航班和票價	飛行
有來自夏洛特下午的航班飛往明尼阿波利斯下午2點左右	航班機票+
告訴我大陸航班離開芝加哥週六凌晨	飛行
什麼是洛根和巴爾的摩之間的最早的航班	飛行
什麼是機場和巴爾的摩之間的地面交通	飛行
從丹佛飛往費城國際信息	飛行
什麼是美國最早的航空公司的航班離開費城達拉斯	飛行
沒有任何一家航空公司有從波士頓飛往匹茲堡的早期下午的航班	飛行
顯示從達拉斯到波士頓七月三十所有航班	航空公司
從休斯敦到達拉斯列表的直飛航班，其晚上8點以後抵達	飛行
我需要去從多倫多聖地亞哥，但我想在丹佛中途停留	飛行
告訴我從波士頓到費城早上航班	飛行
在週三上午的早班機從巴爾的摩到紐瓦克	飛行
哪些航班從有到孟菲斯拉斯維加斯	飛行
什麼從華盛頓到多倫多的航班	飛行
找到從夏洛特到拉斯維加斯是停在ST飛行。路易供應正餐，我想找到這個航班的航空公司	飛行
什麼才是從聖何塞到休斯頓最早的航班	飛行
多少航班DL 402從丹佛飛往費城成本	飛行
什麼是今天的最後一個航班離開巴爾的摩波士頓	機票
告訴我從匹茲堡飛往波士頓的航班的航空公司，請	飛行
第一類從底特律到ST。聖彼得堡	航空公司
我想去從舊金山到丹佛	飛行
找到從波士頓到舊金山最早的航班，供應一餐	飛行
找到從達拉斯往返航班飛往匹茲堡的行程安排	飛行
告訴我從密爾沃基到奧蘭多在週三晚上或週四上午航班	飛行
確實DL立場三角洲	飛行
列出所有離開丹佛大陸上週日2134後航班	縮寫
從華盛頓到舊金山所有頭等艙航班上市	飛行
給我從紐約到拉斯維加斯直飛航班	飛行
I'd喜歡的書從丹佛飛往匹茲堡的航班和I'd喜歡去東方航空	飛行
告訴我從紐瓦克飛往坦帕上週五的航班	飛行
從匹茲堡飛往巴爾的摩上午10點到下午2點之間的航班	飛行
什麼是從波士頓起飛的航班丹佛在下週一時間表	飛行
讓我從舊金山到波士頓在中午之前出發的所有直達航班	飛行時間
什麼是所有可用的飯菜	飛行
給我上月最便宜的航班第十四巴爾的摩抵達達拉斯開始	膳食
我需要從舊金山到波士頓的班機是早上7點後葉	飛行
從費城到多倫多	飛行
什麼是從華盛頓到舊金山的最低票價	飛行
什麼航班有從紐約到拉斯維加斯	機票
什麼是從波士頓首飛到亞特蘭大	飛行
請給我航班時刻表從巴爾的摩到費城	飛行
什麼航班從堪薩斯城到丹佛後，845在上午	飛行
什麼是從波士頓機場的地面交通波士頓市中心	飛行
達拉斯奧克蘭週一	飛行
從波士頓到華盛頓特區的所有航班十一月十一	飛行
你可以請找我從亞特蘭大到巴爾的摩直飛航班是波音757抵達晚上7點	飛行
是什麼在波士頓和丹佛之間的早晨可用的航班	飛行
在達拉斯和波士頓地面交通	飛行
你有沒有從亞特蘭大飛往波士頓將在華盛頓停止	飛行
我住在丹佛和I'd喜歡做一趟亞特蘭大	飛行
告訴我從丹佛飛往巴爾的摩美國航班	飛行
是BWI華盛頓	飛行
列出從紐約到邁阿密在週二這是直飛航班，成本低於466美元	市
我想從丹佛飛往波士頓	飛行
什麼航班做你已經離開丹佛和舊金山抵達	飛行
什麼航空公司從費城飛往舊金山	飛行
我想在大陸航空於八月二十到匹茲堡航班從華盛頓	航空公司
告訴我從巴爾的摩到奧克蘭的航班晚餐	飛行
讓我在週三的最後一個航班從亞特蘭大飛往丹佛	飛行
我想使華盛頓和舊金山之間往返	飛行
有多少是從丹佛飛往匹茲堡最便宜的航班在亞特蘭大停止	飛行
什麼呢ORD平均	機票
什麼是第一個在六月連接從芝加哥飛往西雅圖的航班	縮寫
怎麼樣四月第二十七丹佛華盛頓	飛行
從波士頓去達拉斯航班什麼	飛行
什麼是SA	飛行
你能告訴我什麼票價可從奧克蘭到達拉斯十二月十六單程只	縮寫
告訴我往返機票從巴爾的摩到亞特蘭大	機票
請告訴我從丹佛飛往巴爾的摩上午10點至下午2點的航班	機票
我需要從舊金山一晚的飛行到波士頓週三	飛行
I'd喜歡從波士頓到舊金山	飛行
我需要從巴爾的摩到達拉斯明天早上航班	飛行
什麼'再從紐約到邁阿密的一種方式最廉價的直飛航班	飛行
列出從奧蘭多飛往堪薩斯城所有的航班，然後明尼阿波利斯	飛行
在紐約我會需要租一輛車	飛行
你能告訴我這是什麼亞特蘭大和丹佛是供應一餐之間去的最早的航班	飛行
讓我從舊金山到波士頓的航班	飛行
是什麼從匹茲堡飛往丹佛的航班	飛行
告訴我從匹茲堡飛往巴爾的摩週四所有航班	飛行
該航班什麼時間離開丹佛去舊金山美國大陸航空公司	飛行
是什麼丹佛和舊金山之間提供的航班下午3點之後	飛行時間
告訴我從巴爾的摩到波士頓的航班	飛行
從匹茲堡到紐瓦克的航班	飛行
從波士頓什麼飛往亞特蘭大最先到達亞特蘭大	飛行
什麼是在七月九日晚上匹茲堡和波士頓之間的航班??時間表	飛行
I'd喜歡通過從丹佛飛往波士頓奧克蘭	飛行時間
你可以列出所有從ST離開航班。路易斯和密爾沃基到達	飛行
告訴我從亞特蘭大到華盛頓特區留下週四航班	飛行
讓我從舊金山到波士頓費城或巴爾的摩的所有航班	飛行
告訴我到達愛領域的航班	飛行
你有沒有從華盛頓夜間飛行到波士頓八月第二十七	飛行
讓我從圣迭戈到杜勒斯所有航班波音767	飛行
是什麼從波士頓到費城的航班	飛行
紐約和邁阿密的教練票價之間的所有往返航班	飛行
I'd像堪薩斯城到洛杉磯航班到達洛杉磯傍晚	飛行
I'd喜歡從達拉斯到巴爾的摩的廉價航班在一月一日	飛行
從丹佛在1000元往返車費費城在1000美元和匹茲堡到費城	飛行
從菲尼克斯到拉斯維加斯上週六	機票
我的目的地是舊金山我住在丹佛我想在八月三十航班在早上上任何一家航空公司，這將讓我有	飛行
告訴我從亞特蘭大上午在三角洲航班	飛行
我想從丹佛飛往匹茲堡	飛行
如何從印第安納波利斯到蒙特利爾晚上	飛行
列出從任何機場巴爾的摩抵達的所有客人在週四上午9時許抵達之前	飛行
告訴我從邁阿密到聖地亞哥的航班在丹佛一站式	飛行
告訴我，從亞特蘭大到費城的最後一次飛行	飛行
有沒有使用J31飛機匹茲堡和巴爾的摩之間的任何航班	飛行
我可以請參閱中午前同日十七月抵達也多倫多航空公司和航班號從紐約到多倫多謝謝	飛行
我需要從巴爾的摩到西雅圖的航班，在明尼阿波利斯站	飛行
什麼地面交通波士頓可用	飛行
你能告訴我從費城飛往達拉斯的航班到達在午後	飛行
我需要從堪薩斯城密蘇里州到猶他州鹽湖城的航班我感興趣的只有達美航空公司航班的那些信息	飛行
我想從奧克蘭到費城飛行在一個在下午5時許抵達	飛行
有來自亞特蘭大通過丹佛往返航班達拉斯	飛行
告訴我早上8點之前，從波士頓八月第二丹佛的三角洲航班	飛行
什麼航班有從巴爾的摩到紐瓦克	飛行
讓我看看休斯頓和拉斯維加斯之間的所有往返航班	飛行
什麼從匹茲堡到紐瓦克航班1020點以後	飛行
多少的費用是從亞特蘭大飛往舊金山	飛行
是什麼從舊金山到丹佛的航班	機票
顯示從紐約到邁阿密在週二，其售價低於466美元的單程直飛航班	飛行
什麼是從波士頓最貴飛往達拉斯的航班往返	飛行
我需要從亞特蘭大到巴爾的摩直飛航班下午5點和下午730之間抵達	飛行
什麼是早上最早的航班離開波士頓巴爾的摩	飛行
告訴我票價不到400美元，從達拉斯到巴爾的摩航班	飛行
還好以下週三，我'd喜歡從孟菲斯去辛辛那提儘早	機票
告訴我飛往丹佛的航班從波士頓去到達在週三上午	飛行
有多少城市是由德國漢莎航空公司提供一流的航班	飛行
讓我從所有機場愛情領域的航班	數量
在那裡，從紐約到洛杉磯的任何航班。其停在密爾沃基	飛行
顯示匹茲堡和巴爾的摩之間的團結航班	飛行
找到從波士頓飛往匹茲堡單程飛行行程安排	飛行
是什麼從波士頓到ST航班。聖彼得堡	飛行
從鳳凰城到底特律航班列表週三	飛行
在哪裡呢三角洲飛，美國沒有按'T	飛行
讓我從明尼阿波利斯飛往西雅圖的航班票價七月第一1993年	飛行
告訴我從紐約的所有票價邁阿密留下一個星期二	機票
我可以從巴爾的摩到亞特蘭大所有的航班星期四列表，下午1時後離開	機票
你能告訴我從奧克蘭到只有達拉斯一種方式十二月十六票價	飛行
告訴我從邁阿密到紐約的票價	機票
告訴我從坦帕到ST單程航班。前聖路易斯上午10一流出發	機票
什麼航班有從洛杉磯到匹茲堡	飛行
多少頭等艙機票確實三角洲航空公司有	飛行
你能告訴我，從波士頓到亞特蘭大下午5點之後的某個時候機票	數量
給我最便宜的單程票價從聖地亞哥飛往邁阿密	飛行
我需要一輛車在紐約	機票
讓我從舊金山到匹茲堡的一個星期天航班	飛行
由達美航空公司提供航班什麼	飛行
什麼航班離開從納什維爾到密爾沃基	飛行
什麼是波士頓和舊金山之間的聯合航空服務	飛行
你能告訴我，丹佛和舊金山之間飛行的航空公司是什麼	飛行
告訴我往返頭等艙機票，從紐約到邁阿密	航空公司
告訴我從底特律飛往威徹斯特縣的飛行最高單程票價	機票
可用週三下午什麼航班從亞特蘭大飛往舊金山	飛行
我想從丹佛飛往舊金山	飛行
我需要從匹茲堡到波士頓的班機上週三第十四	飛行
什麼是你的最後一個航班離開舊金山和丹佛到達	飛行
告訴我票價為頭等艙機票從巴爾的摩到達拉斯	飛行
什麼是華盛頓和波士頓之間的航班??下午	機票
還好在週二六月第一我'd像鳳凰去底特律，在下午晚些時候	飛行
哪些航班可供週五下午從亞特蘭大飛往達拉斯	飛行
告訴我對我們的頭等艙機票價格空氣從克里夫蘭到邁阿密往返	飛行
其中三角洲航班從舊金山中午12時後前往波士頓朝離開	機票
顯示從費城飛往達拉斯上週六航班	飛行
從匹茲堡飛往巴爾的摩上午10點到下午2點之間的航班	飛行
紐約和聖何塞之間的航班	飛行
是什麼從波士頓到華盛頓的航班	飛行
我要飛從波士頓到巴爾的摩	飛行
從波士頓去什麼飛往華盛頓的航班下週二	飛行
什麼才是從波士頓到華盛頓國際最早的航班，供應午餐	飛行
告訴我在巴爾的摩汽車租賃	飛行
告訴我從匹茲堡飛往亞特蘭大週三最便宜的航班，其葉子在中午之前，供應早餐	飛行
I'd喜歡了解最新的航班從亞特蘭大到波士頓	飛行
所有達拉斯往返航班和票價從匹茲堡12點後不到1100元	飛行
哪些呢票價代碼QO平均	航班機票+
什麼是孟菲斯最早的航班到辛辛那提在六月三十	縮寫
並中西部快捷任何航班	飛行
我找了一個起飛的航班丹佛前往亞特蘭大，並在匹茲堡停止這是可能的	飛行
什麼是AP57限制	飛行
我想訂一張從巴爾的摩到紐瓦克航班一大早上月第九	縮寫
我需要從達拉斯到休斯敦的早班機	飛行
告訴我從奧克蘭飛往華盛頓的航班	飛行
告訴我從波士頓到舊金山聯合航空公司航班	飛行
什麼是從波士頓到舊金山的最低票價	飛行
告訴我在巴爾的摩從費城抵達航班在4點鐘左右	機票
什麼航班沒有從印第安納波利斯飛往奧蘭多	飛行
請列出印第安納波利斯之間的所有航班和奧蘭多二十七個十二月	飛行
我住在蒙特利爾，我想前往芝加哥，然後印第安納波利斯，然後回家	飛行
讓我從華盛頓飛往舊金山的航班在丹佛停留	飛行
我想訂於二月第二十二邁阿密美國航空頭等艙航班從克利夫蘭	飛行
告訴我從費城飛往達拉斯的航班	飛行
什麼從聖航班。保羅堪薩斯城上週五隨餐	飛行
你可以列出從奧克蘭到鹽湖城週四最早的航班	飛行
告訴我從波士頓到費城的航班	飛行
告訴我從聖航班。在聖彼得堡抵達多倫多中午前	飛行
顯示從匹茲堡飛往丹佛的所有星期二上午航班	飛行
讓我知道從夏洛特飛往費城國際	飛行
從西雅圖到鹽湖城	飛行
請再告訴我費城丹佛週六航班	飛行
告訴我從波士頓到丹佛這在週三中午前到達所有航班	飛行
什麼在六月十五連接從芝加哥飛往西雅圖成	飛行
I'd像波士頓華盛頓信息	飛行
我想預定在達美航空公司從華盛頓到舊金山使其儘早飛行	飛行
我需要從紐約到舊金山的航班	飛行
I'd喜歡去波士頓從丹佛和I'd喜歡到那裡	飛行
什麼是巴爾的摩最便宜的航班到舊金山	飛行
在匹茲堡I'd喜歡租一輛車	飛行
讓我從聖地亞哥到洛杉磯的所有航班	飛行
讓我知道，在巴爾的摩1850至午夜到達任何地方的航班	飛行
列出從費城飛往達拉斯的美國航空航班	飛行
什麼是從鹽湖城到鳳凰城的最新航班	飛行
給我最昂貴的票價	飛行
在那裡，從亞特蘭大到華盛頓任何早期的航班星期四上午	機票
給我最昂貴的票價	飛行
我需要一個航班從西雅圖離開巴爾的摩明尼阿波利斯拍個不停	機票
這是什麼意思我們	飛行
我想訂在我們飛行空氣克利夫蘭一流邁阿密二月廿四	縮寫
是什麼從匹茲堡飛往波士頓的所有航班上週三	飛行
什麼樣的飛機是從丹佛飛UA 270費城	飛行
從費城飛往舊金山的航班信息	飛機
告訴我，從亞特蘭大到波士頓晚上航班	飛行
顯示任何航班上週日離開舊金山和匹茲堡到達	飛行
什麼是最便宜的單程票價從舊金山到波士頓週三八月二十一	飛行
從波士頓最短飛行到費城	機票
好吧，現在我想在4月的一項航班信息從匹茲堡第二十七亞特蘭大清晨留下大約8點	飛行
I'd喜歡尋找從亞特蘭大到達拉斯的最低票價	飛行
從列出ST最早的航班。保羅聖何塞	機票
你可以列出所有從出發到奧蘭多堪薩斯城航班	飛行
I'd喜歡安排從匹茲堡到亞特蘭大的航班	飛行
給我從紐約到拉斯維加斯週日拉斯維加斯週日航班和航班從孟菲斯	飛行
告訴我，從多倫多飛往舊金山的航空公司	飛行
找到丹佛和奧克蘭之間的航班??飛行，應在下午離開，下午5點的航班也應該是馬不停蹄來到附近	航空公司
舊金山和丹佛之間請名單航班	飛行
什麼航班有從明尼阿波利斯到紐瓦克的大陸	飛行
從舊金山到丹佛航班列表上週五	飛行
有一個航班，1505從匹茲堡離開巴爾的摩七月二十五分之一1991	飛行
告訴我奧蘭多國際和奧蘭多之間的地面交通	飛行
有從亞特蘭大到費城直達航班到達費城中午12點左右	飛行
我需要從波士頓去亞特蘭大在同一天找我從波士頓最早的航班	飛行
該航空公司從舊金山前往華盛頓印第安納波利斯的方式	飛行
美國航空公司在離開鳳凰	航空公司
我也有興趣在從ST運行的飛行。路易拉斯維加斯	飛行
列出週三從巴爾的摩到紐瓦克中午之前所有的直飛航班	飛行
是什麼堪薩斯城伯班克的航班上週六可22對西南	飛行
告訴我從邁阿密到紐約的票價	飛行
什麼從拉斯維加斯到圣迭戈航班	機票
什麼是票價代碼H	飛行
告訴我從巴爾的摩到費城2100之後抵達的航班	縮寫
你有沒有從舊金山到亞特蘭大的航班上午8點左右	飛行
你有沒有從丹佛在清晨的美國航空公司飛往舊金山	飛行
顯示來自匹茲堡的航班到舊金山	飛行
什麼從芝加哥飛往堪薩斯城上午	飛行
請求來自波士頓的航班信息丹佛週三	飛行
是什麼從丹佛飛往巴爾的摩的航班八月十	飛行
列出從密爾沃基的所有美國航空公司飛往鳳凰城在週日	飛行
告訴我從辛辛那提飛往丹佛的航班	飛行
你能告訴我是什麼的縮寫我們代表	飛行
在費城提供地面運輸	縮寫
列出所有從丹佛飛往費城國際	飛行
什麼才是從達拉斯到巴爾的摩最低往返票價	飛行
告訴我航班的航空公司或從愛場	機票
American Airlines從鳳凰到丹佛	航空公司
你好，我想計劃從波士頓到丹佛航班	飛行
所有航班巴爾的摩下午6時後	飛行
什麼是票價代碼F	飛行
什麼從波士頓飛往匹茲堡的航班723點後	縮寫
有多少航班就大陸航空公司有一類服務代碼的F	飛行
I'd像在達拉斯停止在費城和舊金山之間的航班??信息	數量
告訴我航班	飛行
讓我在達美航空公司亞特蘭大和奧克蘭之間的QX航班票價	飛行
什麼地面交通舊金山可用	飛行
I'd像早期飛行明天從哥倫布到納什維爾	飛行
什麼地面交通有亞特蘭大	飛行
告訴我在數據庫中的最低票價	飛行
告訴我從塔科馬到邁阿密航班下午6時後	最便宜
請給我從丹佛飛往匹茲堡最便宜的航班	飛行
給我從巴爾的摩到紐瓦克航班到達儘早	飛行
什麼才是最低往返票價從丹佛飛往亞特蘭大	飛行
有多少城市被TWA提供一流的航班	機票
什麼是最便宜的單程票價從丹佛飛往匹茲堡	數量
讓我知道從費城到舊金山航班	機票
告訴我從匹茲堡到舊金山頭等艙我們空氣航班週一	飛行
我想我的起源在華盛頓直飛丹佛舊金山的目的地城市	飛行
你可以給我從亞特蘭大到丹佛的最新航班上七月初七	飛行
從機場到波士頓市區地面交通信息	飛行
在四月十五我想從波士頓清晨飛往亞特蘭大	飛行
我如何從多倫多機場到市中心	飛行
什麼才是最低往返票價從丹佛飛往匹茲堡	飛行時間
名單上週一離開大陸丹佛所有航班	機票
什麼是最早的航班離開波士頓並於11月在第七次來到亞特蘭大	飛行
從安大略塔科馬上午在任何一天和一流的10臨走單程航班	飛行
在丹佛西北停航班	飛行
讓我從華盛頓到舊金山的航班在丹佛停留	飛行
I'米飛行從波士頓到達拉斯	飛行
該航空公司擁有比任何其他航空公司更多的商業類航班	飛行
我要離開芝加哥下週二在底特律下午6時左右抵達	航空公司
該航空公司有匹茲堡和巴爾的摩之間的連接	飛行
I'd喜歡從波士頓在週二和我離開'd喜歡在早上的某個時候離開	航空公司
確實美國航空公司航班從長灘到ST。路易斯在達拉斯停止供應午餐	飛行
可供巴爾的摩八月第三航班從達拉斯哪家航空公司有最便宜的航班	飛行
感謝什麼的從華盛頓到波士頓的最後一個航班返回	飛行
其中三角洲航班從波士頓飛往費城	飛行
告訴我從波士頓到奧克蘭航班	飛行
調出從密爾沃基飛往奧蘭多的航班在週三晚上或週四上午	飛行
從長灘到哥倫布航班上第二十七	飛行
什麼航班離開西雅圖週日在大陸	飛行
什麼航班從舊金山到波士頓和休假後1點	飛行
告訴我從丹佛飛往費城的航班	飛行
顯示來自費城達拉斯早晨航班	飛行
告訴我在費城的地面交通安排在週三上午	飛行
所有從巴爾的摩到舊金山航班	飛行
讓我從舊金山到波士頓十一月十的所有航班	飛行
哪個時區是在丹佛	飛行
這是什麼意思我們	市
告訴我從密爾沃基到奧蘭多的所有航班	縮寫
從美國辛辛那提飛往休斯敦霍比	飛行
我怎樣才能從波士頓到亞特蘭大，並在同一天回來，有最小時在亞特蘭大地面	飛行
有沒有從丹佛飛往匹茲堡亞特蘭大連接任何航班	飛行
所有你有沒有從華盛頓到波士頓的班機，在費城停止	飛行
告訴我從坦帕飛往夏洛特週日航班	飛行
什麼航班有來自亞特蘭大大陸	飛行
有晚上的美國航空公司航班從達拉斯到舊金山	飛行
什麼是美國的早上飛往亞特蘭大時間表	飛行
什麼是YYZ	飛行時間
告訴我所有的飛行，那出發從舊金山去要么波士頓費城或巴爾的摩	縮寫
列出使用美國航空公司的波士頓和奧克蘭以及波士頓和奧克蘭之間的所有的每日航班	飛行
你能告訴我從丹佛往返航班匹茲堡的成本	飛行
顯示從匹茲堡飛往奧克蘭通過丹佛轉機	機票
我喜歡看12點以後從匹茲堡飛往舊金山的航班離開匹茲堡信息	飛行
列出所有飛入米切爾將軍國際航空公司	飛行
給我最便宜的單程票價從巴爾的摩到達拉斯	航空公司
讓我從鹽湖城到辛辛那提所有的直飛航班	機票
什麼下午航班從亞特蘭大飛往舊金山	飛行
什麼航空公司有波士頓和舊金山之間的商業級服務	飛行
飛機的類型用於從亞特蘭大飛往丹佛的中午12點之前什麼	航空公司
告訴我奧克蘭到達拉斯的航班	飛機
多少頭等艙機票不團結今天所有城市都留下	飛行
什麼是離開底特律和芝加哥晚上7點左右下週三到達的航班	數量
什麼堪薩斯城伯班克的直飛航班抵達六可22	飛行
什麼樣的飛機均採用由華盛頓和丹佛之間飛行達美航空公司	飛行
什麼是從波士頓到奧克蘭最早的航班，供應一餐	飛機
從丹佛飛往費城週六下午	飛行
告訴我中午離開，下午5點後抵達丹佛和奧克蘭之間的所有直達航班	飛行
什麼類型的地面交通的可在費城機場	飛行
票價和從丹佛飛往費城國際	飛行
我想從辛辛那提到伯班克飛行的美國航空公司，並在下午離開	機票
沒關係，你可以讓我從印第安納波利斯到堪薩斯城往返票	飛行
你能告訴我從巴爾的摩到達拉斯可用廉價航班在經濟艙票價	機票
讓我從舊金山到美國匹茲堡航航班上週二	飛行
從印第安納波利斯飛往西雅圖的航班	飛行
列出從費城到舊金山通過達拉斯的航班	飛行
我想從波士頓到丹佛的航班上週一	飛行
大約在丹佛租車什麼	飛行
請告訴我家航空公司從丹佛飛往費城國際	飛行
什麼航班離開從納什維爾飛往菲尼克斯	航空公司
I'd喜歡從亞特蘭大飛往丹佛八月第二十九	飛行
什麼地面交通有在丹佛	飛行
有多少是來自華盛頓頭等艙機票舊金山離開上週五	機票
告訴我從匹茲堡飛往亞特蘭大週一下午航班	機票
我想預訂5月二十歲的航班從坦帕第六打算如果可能的話密爾沃基直達航班	飛行
告訴我從波士頓到舊金山停止在達拉斯美航航班	飛行
是什麼限制美聯社57	飛行
I'd想知道從波士頓到費城直飛信息	縮寫
顯示從巴爾的摩到達拉斯我非頭等艙機票	飛行
我可以從達拉斯到舊金山留在早上和上午抵達	飛行
顯示從丹佛飛往波士頓的所有星期三上午航班	飛行
哪些航班可供週五下午從費城到加利福尼亞州奧克蘭	飛行
從舊金山到波士頓中午前離開所有航班	飛行
從安大略飛往奧蘭多的航班	飛行
週三從巴爾的摩到紐瓦克	飛行
往返票價從巴爾的摩到費城低於1000美元	飛行
還好週一可能第三十一個I'd喜歡從聖地亞哥到鳳凰清晨	機票
列出從丹佛到舊金山在週三下午的所有航班	飛行
什麼是從匹茲堡到亞特蘭大最便宜的航班	飛行
確實西北飛入丹佛	飛行
顯示從紐約到拉斯維加斯的航班	飛行
我想從丹佛飛往波士頓週三二十一	飛行
I'd喜歡從波士頓飛往巴爾的摩	飛行
奧克蘭舊金山取悅早餐飛行	飛行
告訴我從波士頓到丹佛服務於午餐的所有航班	飛行
我想去從波士頓到奧克蘭	飛行
什麼是從丹佛飛往舊金山的航班的成本	飛行
從匹茲堡飛往費城的所有航班下週二到達近6點	機票
您好，我需要從紐瓦克去納什維爾的美國航空公司630左右離開時	飛行
告訴我，從亞特蘭大到華盛頓晚上航班星期三	飛行
告訴我從邁阿密到紐約的直飛航班與經濟艙票價	飛行
從亞特蘭大到匹茲堡航班信息	飛行
告訴我從蒙特利爾飛往納什維爾的所有航班	飛行
請給我從巴爾的摩到費城可用航班	飛行
告訴我從達拉斯到巴爾的摩的航班有415元車費	飛行
告訴我從匹茲堡到費城的航班	飛行
從舊金山到匹茲堡航班上週五我在請求航班信息	飛行
從舊金山三角洲航班，請	飛行
請列出從堪薩斯城到鹽湖城的所有增量航班	飛行
哪些航班可以從達拉斯到亞特蘭大單程經濟艙票價	飛行
我如何從BWI到華盛頓得到	飛行
I'd像所有的從舊金山飛往匹茲堡的航班上週日的列表，請	飛行
有沒有從丹佛直飛匹茲堡在八月三十日上午首先是不間斷	飛行
I'd喜歡從丹佛購買經濟艙機票亞特蘭大在匹茲堡停留	飛行
告訴我從費城飛往達拉斯其上週六下午3點前抵達達拉斯的所有航班	機票
顯示從舊金山到丹佛在週四航班	飛行
請列出從聖週五晚上的航班。保羅堪薩斯城	飛行
是什麼從波士頓到巴爾的摩的航班	飛行
讓我們看看有多少會從亞特蘭大到丹佛直飛的航班在5月第七	飛行
我從達拉斯飛往舊金山的航班	機票
告訴我從芝加哥到堪薩斯城週四六月十七抵達堪薩斯城的所有航班在晚上7點左右	飛行
奧克蘭和丹佛之間的名單列表航班	飛行
什麼西北航班在中午前離開丹佛	飛行
該航空公司從BWI飛往達拉斯	飛行
告訴我從匹茲堡到巴爾的摩的所有航班星期六	航空公司
美國航空公司從丹佛飛往密爾沃基	飛行
我需要在週四的航班信息離開匹茲堡，並在上午抵達巴爾的摩	飛行
你有沒有從費城到匹茲堡清晨直航	飛行
從華盛頓飛往鹽湖城	飛行
什麼地面交通舊金山可用	飛行
是什麼從丹佛飛往奧克蘭的航班	飛行
是什麼在週二十月第一次從亞特蘭大到巴爾的摩的航班	飛行
I'd喜歡看到從巴爾的摩到亞特蘭大的當天中午前抵達航班和I'd喜歡看到從丹佛飛往亞特蘭大當天中午前到達航班	飛行
告訴我所有的費城和丹佛的航班	飛行
告訴我從波士頓飛往匹茲堡的航班上週三1700小時後	飛行
告訴我從紐約往返機票邁阿密	飛行
什麼是地面交通的從華盛頓機場到市區的時間表	機票
我想從費城飛往達拉斯舊金山週一七月十八	飛行時間
從達拉斯清單成本最低的航班巴爾的摩，供應一餐	飛行
告訴我所有的奧克蘭和丹佛之間的航班	飛行
讓我看看丹佛和巴爾的摩之間航班	飛行
給我往返車費教練從巴爾的摩到達拉斯	飛行
告訴我最新的飛行場戀愛	機票
什麼航班巴爾的摩和波士頓之間可在八月十二	飛行
什麼是EWR	飛行
讓我從舊金山到匹茲堡上週五的所有航班	縮寫
是什麼從塔科馬到聖何塞的航班上週三十九	飛行
而我就需要地面交通週二七月六至週三在聖地亞哥七月初七	飛行
我想航班號和最便宜的票價的時間是從舊金山最便宜的頭等艙票價匹茲堡晚上8點週一晚上離開後，	縮寫
我想飛到丹佛低於500美元的請告訴我匹茲堡和丹佛的機票	航班號
往返票價從巴爾的摩到費城低於1000美元或往返票價從丹佛飛往費城低於1000美元或往返票價從匹茲堡飛往費城低於1000美元	飛行
請列出從華盛頓特區到亞特蘭大的航班	機票
找到從達拉斯往返航班飛往匹茲堡的行程安排	飛行
從蒙特利爾飛往華盛頓的航班表與最低的單程票價是葉子上週六	飛行
什麼是從亞特蘭大到達拉斯早晨的航班價格	飛行
I'd像所有從舊金山飛往匹茲堡的航班上週二信息	機票
你能告訴我有關達拉斯機場和達拉斯市中心之間的地面交通	飛行
告訴我城市通過nationair和加拿大國際航空公司都提供	飛行
有多少航班確實東方航空公司從波士頓到亞特蘭大有	市
什麼機場是在坦帕	數量
這是什麼費用從波士頓飛往舊金山聯合航空公司航班21	飛機場
我想從聖地亞哥飛往印第安納波利斯航班離開週二下午	機票
從匹茲堡飛往亞特蘭大的航班上午週三	飛行
什麼來自芝加哥的航班離開西雅圖星期六	飛行
列出所有航班會從波士頓到亞特蘭大點鐘在週四前5名	飛行
有多少是來自亞特蘭大的頭等艙往返於舊金山	飛行
我想從波士頓前往亞特蘭大週一	機票
大約從波士頓到圣迭戈航班什麼	飛行
告訴我，從亞特蘭大到巴爾的摩的航班	飛行
什麼才是從奧克蘭最廉價的單程航班華盛頓	飛行
告訴我從愛領域的航班	飛行
我需要從聖地亞哥到鳳凰直達航班	飛行
什麼航班有從亞特蘭大到週四奧克蘭	飛行
什麼堪薩斯城飛往芝加哥的航班在芝加哥下週三到達下午7點	飛行
我想第一本關於美國大陸航空公司從芝加哥航班到西雅圖六月	飛行
什麼從拉斯維加斯飛往蒙特利爾的航班上週六	飛行
列出從丹佛到芝加哥大陸的所有航班上934點後離開週日	飛行
什麼航班在下午離開亞特蘭大，在約3和抵達舊金山	飛行
告訴我從丹佛飛往匹茲堡其中端出了後天的所有航班	飛行
從亞特蘭大機場到亞特蘭大市中心有地面交通	飛行
請給我從丹佛飛往費城票價	飛行
我需要離開丹佛的航班後，晚上7點下週一飛往匹茲堡	機票
列出所有到達米切爾將軍國際航班	飛行
在丹佛地面交通信息	飛行
從洛杉磯到匹茲堡名單的直飛航班，其下午5點以後抵達週一	數量
匹茲堡週三亞特蘭大	飛行
美的空調269離開波士頓的428是什麼在巴爾的摩到達時間	飛行
什麼航空公司DL 98	飛行
什麼是票價代碼F和Fn平均	航空公司
航班從波士頓到巴爾的摩	縮寫
上週四匹茲堡的所有航班和票價從丹佛對我們的空號1039	飛行
該航空公司從波士頓飛往舊金山	航班機票+
你有沒有從夏洛特飛往亞特蘭大下週二	航空公司
告訴我所有的航班到達中午左右在華盛頓特區丹佛	飛行
我需要十個人從鳳凰城到圣迭戈，請給我在工作日期間的航班	飛行
請列出任何可用的航班離開加州奧克蘭抵達週二週三費城	飛行
顯示從紐約到拉斯維加斯的航班	飛行
其中美國航空公司航班經過丹佛	飛行
什麼地面交通是到華盛頓	飛行
什麼亞特蘭大和丹佛之間的往返航班晉級票價代碼QX	市
什麼亞特蘭大和華盛頓之間的直飛航班下午6點後離開亞特蘭大	飛行
所有航班匹茲堡巴爾的摩週四抵達上午10點	飛行
我想在底特律下午6點左右到達，我是從芝加哥離開	飛行
什麼是從達拉斯去一個辦法舊金山十一月十七票價	飛行
這是從費城美國空中飛行到波士頓的航班號是279還是137338	機票
列出從匹茲堡所有往返票價華盛頓	航班號
請告訴我從達拉斯飛往丹佛的航班	機票
什麼地面交通有亞特蘭大	飛行
是否有與在TWA達拉斯 - 沃斯堡停留奧克蘭和波士頓之間的航班	飛行
從匹茲堡機場匹茲堡市中心有地面交通	飛行
什麼是從亞特蘭大前往巴爾的摩的第一次飛行，供應早餐	飛行
什麼是從波士頓到丹佛的最新航班享用一頓	飛行
從肯尼迪國際機場或轉機拉瓜迪亞克利夫蘭	飛行
什麼呢碼Y平均值	飛行
沒有飛行UA 270從丹佛飛往費城吃飯	縮寫
從亞特蘭大到波士頓航班列表週三下午	飛行
從丹佛一月十三1992年航班信息舊金山	飛行
你有沒有從丹佛八月三十清晨增量飛往舊金山	飛行
航班離開巴爾的摩和亞特蘭大到達我需要的信息	飛行
顯示所有達拉斯航班費城	飛行
哪些呢票價代碼M平均	飛行
什麼是最低票價從丹佛飛往匹茲堡	縮寫
從鹽湖城到如果可能的話辛辛那提直飛航班往返航班	機票
I'd像來自亞特蘭大的TWA航班匹茲堡與沃斯堡達拉斯稍作停留，請	飛行
什麼時候從波士頓出發TWA去舊金山	飛行
給我最早的航班從明天ST的。聖彼得堡密爾沃基比TWA以外的航空公司	飛行時間
是什麼的縮寫D10	飛行
紐瓦克到克利夫蘭	縮寫
告訴我從匹茲堡飛往費城如上午08點在週三抵達前的所有航班	飛行
列出從達拉斯到舊金山的美國航空公司航班	飛行
什麼時候從亞特蘭大前往丹佛休假最早的航班	飛行
飛機的列表類型的波士頓和舊金山之間飛行	飛行時間
告訴我從波士頓到沃斯堡的航班七月十1991上午	飛機
I'd像從波士頓到舊金山最便宜的單程票價	飛行
告訴我這下午5時後離開匹茲堡明天抵達巴爾的摩的所有航班	機票
什麼是在費城的現有地面交通	飛行
你有沒有到舊金山航班的任何聯合航空公司從達拉斯	飛行
什麼是UA	飛行
我想安排從丹佛飛往匹茲堡的航班	縮寫
什麼航空公司從ST飛。聖彼得堡密爾沃基和密爾沃基塔科馬	飛行
多少的費用是從波士頓飛往巴爾的摩的一個星期六	航空公司
週一I'd喜歡從拉斯維加斯到底特律密執安旅遊	機票
告訴我，從堪薩斯城到芝加哥六月的所有航班十六晚上到達7點左右	飛行
波士頓丹佛週一	飛行
告訴我TWA航班539	飛行
什麼是從匹茲堡到巴爾的摩最小的飛機飛行提供到達五月十七	飛行
我需要從丹佛飛往費城的航班	飛機
什麼是從波士頓一種方式車費的價格丹佛的美國大陸航空公司	飛行
是什麼夏洛特的航班價格從洛杉磯週一上午	機票
告訴我從波士頓到匹茲堡留下週三和週四的航班	飛行
顯示票價和航班從丹佛飛往奧克蘭	飛行
你能告訴我從亞特蘭大最新晚上飛往丹佛的航班上七月初七	機票
告訴我在舊金山地面交通	飛行
丹佛和匹茲堡之間的航班??列表	飛行
哪些航班可以從匹茲堡飛往巴爾的摩七月二十五分之一1991	飛行
告訴我晚上航班巴爾的摩	飛行
從芝加哥到堪薩斯城航班什麼	飛行
I'd喜歡從丹佛飛往匹茲堡在亞特蘭大停止	飛行
是什麼從亞特蘭大到巴爾的摩下午航班	飛行
讓我從舊金山到丹佛平日航班	飛行
告訴我從達拉斯到巴爾的摩頭等艙的航班	飛行
的確，從亞特蘭大到舊金山三角洲飛	飛行
讓我在丹佛的地面交通	飛行
顯示所有票價代碼	飛行
什麼航班亞特蘭大停止中午前	機票
從孟菲斯到邁阿密最便宜的航班	飛行
讓我知道從丹佛飛往巴爾的摩的航班	飛行
給我從達拉斯到巴爾的摩最廉價的往返航班	飛行
有哪些不同類，航空公司的優惠	飛行
I'd喜歡看到所有票價從丹佛飛往亞特蘭大的航班	飛行
不東航波士頓和華盛頓之間的飛	飛行
告訴我從費城到舊金山航班星期三	飛行
I'd喜歡預定從波士頓到舊金山的美國航空公司航班的在匹茲堡一站式	飛行
什麼樣的地面交通的亞特蘭大可用	飛行
什麼是最便宜的單程票價從波士頓到華盛頓	飛行
奧克蘭航班和票價從丹佛	機票
找我從波士頓到華盛頓最便宜的航班	航班機票+
什麼是服務於TWA類	飛行
什麼樣的飛機，你已經從波士頓飛往舊金山八月第二十七	飛行
精細你能不能給我的地面交通信息，在華盛頓市區	飛機
我想從奧克蘭到波士頓的直航航班上週三葉子	飛行
什麼航班可今天從波士頓到丹佛	飛行
舊金山丹佛	飛行
告訴我從費城到舊金山的所有航班在達拉斯一站式	飛行
顯示從多倫多到圣迭戈美國航空在丹佛停止在所有航班	飛行
有多少是從波士頓頭等艙機票舊金山	飛行
奧克蘭費城	機票
請告訴我在丹佛的所有機場	飛行
波士頓和奧克蘭使用TWA之間名單往返航班	飛機場
讓我從舊金山到波士頓的航班	飛行
給我12和4之間下午全部美國空軍航班匹茲堡	飛行
我想從舊金山飛往華盛頓的航班日晚時間表	飛行
什麼是從達拉斯票價到舊金山的航班DL 217	飛行時間
什麼樣的地面交通的有丹佛	機票
你能告訴我，通過從達拉斯飛往華盛頓到舊金山航班列表	飛行
什麼是從波士頓首飛到達拉斯	飛行
從亞特蘭大東部蒼蠅丹佛你下午6點之前使用何種類型的飛機	飛行
告訴我從密爾沃基飛往奧蘭多的航班在中午前的星期四	飛行
並曼聯從邁阿密到華盛頓飛行週三	飛行
我想從舊金山到丹佛起飛的航班舊金山下午在下午抵達丹佛周圍5	飛行
是什麼從波士頓到華盛頓的航班十月十五1991	飛行
從丹佛飛往匹茲堡的航班上週三	飛行
有多少人飛渦輪螺旋槳飛機	飛行
請列出中午前所有航班到丹佛的美國聯合航空公司和美國西北航空公司	容量
哪些航班可以從丹佛到費城週三	飛行
哪些航班可以從舊金山到匹茲堡在星期一早上	飛行
讓我知道從巴爾的摩飛往費城國際	飛行
什麼是對從波士頓節儉經濟飛往舊金山票價	飛行
如何從機場匹茲堡到達市中心	機票
是否有可能對我來說，從巴爾的摩飛往舊金山	飛行
找旅行社安排從波士頓的往返航班飛往匹茲堡	飛行
沒有任何地面交通的城市在達拉斯	飛行
什麼是從鹽湖城到ST最新的航班。聖彼得堡	飛行
現在我'd像從丹佛飛往舊金山的航班信息	飛行
我可以看到st所有的直飛航班。聖彼得堡夏洛特	飛行
從巴爾的摩到舊金山	飛行
告訴我，從丹佛飛往舊金山的航空公司	飛行
往返票價從丹佛飛往費城低於1000美元	航空公司
我想從費城飛往達拉斯航班	機票
我需要從波士頓飛往巴爾的摩，請給我你的早晨航班的時間之前8點	飛行
告訴我愛情領域從所有其他機場到達航班	飛行
在紐約機場	飛行
你能告訴我從費城飛往達拉斯航班的航班應該離開費城上午	飛機場
什麼航空公司從多倫多飛往聖地亞哥在丹佛停留	飛行
十一月十三哪些航班波士頓和丹佛之間可在美國航空公司	航空公司
讓我知道從匹茲堡飛往達拉斯的航班	飛行
從休斯敦到密爾沃基的美國航空公司航班什麼上週五	飛行
我想上週二上午費城和匹茲堡之間的早班飛機	飛行
什麼是最便宜的往返票價從亞特蘭大到匹茲堡	飛行
什麼是從波士頓首飛到舊金山週六	機票
顯示在我們的空氣從波士頓飛往多倫多的商務艙票價	飛行
告訴我從紐約往返票價邁阿密	機票
什麼是一流的票價從波士頓到達拉斯	機票
讓我從舊金山到華盛頓特區的所有航班	機票
我想從華盛頓乘坐聯合航空公司美國科羅拉多州丹佛市	飛行
在那裡，從亞特蘭大到巴爾的摩任何航班	飛行
I'd像一個飛行明天從哥倫布到休斯敦在納什維爾短暫停留	飛行
I'd喜歡預訂從亞特蘭大最便宜的航班丹佛八月第一	飛行
讓我在六月二十有公務艙了波士頓的所有航班	飛行
告訴我從巴爾的摩到達拉斯的航班價格	飛行
什麼地面交通夏洛特可用	機票
幾站從波士頓到舊金山的所有航班之前出發中午12時許	飛行
我想從亞特蘭大到丹佛航班	數量
在那裡達拉斯和波士頓之間的任何大陸航班	飛行
而我“在匹茲堡m什麼地面交通可用	飛行
告訴我從巴爾的摩到達拉斯的航班	飛行
哪些呢票價代碼QX平均	飛行
告訴我從邁阿密到紐約留下的一個星期天頭等艙機票	縮寫
我想預定八月第二十七我們空氣巴爾的摩飛往奧克蘭你可以做什麼航班	飛行
在亞特蘭大我想對地面交通信息	飛行
請列出從夏洛特到明尼阿波利斯下午航班	飛行
在TWA從哥倫布到ST經濟艙機票。保羅	飛行
我想從達拉斯飛往舊金山	飛行
什麼是最新的航班離開波士頓丹佛	飛行
你有沒有從波士頓到舊金山的航班與沃斯堡達拉斯停留	飛行
列出從巴爾的摩到亞特蘭大星期四中午直飛畢竟航班	飛行
告訴我第一類從巴爾的摩到達拉斯的所有價格	飛行
列出從匹茲堡飛往波士頓整天時間航班	機票
告訴我費城和丹佛之間的所有漢莎航班	飛行
告訴我往返票價從巴爾的摩到費城	飛行
我想從費城飛往達拉斯	機票
請列出我在波士頓和丹佛之間的聯合航空公司航班	飛行
是什麼密爾沃基到奧蘭多航班在週三晚上	飛行
解釋限制ap80	飛行
是DFW和奧克蘭之間的航班??是什麼	縮寫
我想從休斯敦到孟菲斯航班週二上午	飛行
什麼是ST夏洛特到達最早的航班。路易斯在週五	飛行
給我下週三從克里夫蘭到邁阿密的美航航班	飛行
告訴我從亞特蘭大到丹佛六四機票	飛行
我需要在機場與市區之間的地面交通信息的城市波士頓	飛行
往返票價從丹佛飛往費城低於1000美元	機票
告訴我從巴爾的摩飛往波士頓的航班	機票
你能告訴我有關American Airlines從華盛頓特區飛行到費城早上盡可能最早的一個信息	飛行
讓我從巴爾的摩或丹佛或匹茲堡飛往費城的所有航班	飛行
沒有大陸航空公司從丹佛飛往舊金山	飛行
這對美國聯合航空公司航班，西北辦理丹佛	飛行
有沒有從波士頓任何節儉經濟飛往舊金山的航班	飛行
I'd也喜歡看從匹茲堡飛往亞特蘭大的航班列表	飛行
請告訴我，之前中午12時許，從亞特蘭大來丹佛飛機的類型	飛行
告訴我從達拉斯到巴爾的摩航班	飛機
給我從紐約到拉斯維加斯是在週日抵達所有航班	飛行
地面交通達拉斯	飛行
航班是否有納什維爾和St之間的東西。路易斯這是馬不停蹄了中午和晚上8點之前到達	飛行
什麼經濟航班從達拉斯到巴爾的摩月第二十五1991	飛行
列出使用美國航空公司波士頓和奧克蘭之間的所有的每日航班	飛行
什麼是從洛杉磯教練票價夏洛特週一上午	飛行
從巴爾的摩到費城的航班，請	機票
什麼類型的飛機，我可以得到一個頭等艙機票從費城飛往達拉斯	飛行
給我從田納西州孟菲斯到北卡羅萊納州夏洛特的航班	飛機
什麼是頭等艙機票的價格從亞特蘭大飛往舊金山	飛行
告訴我從波士頓到丹佛週三中午之前到達其在丹佛的所有航班	機票
確實從丹佛飛往舊金山飛大陸	飛行
從丹佛飛往費城的航班列表	飛行
請給我的飛行時間我想8日前從波士頓飛往巴爾的摩上午	飛行
告訴我從匹茲堡飛往費城國際	飛行時間
告訴我要離開鳳凰城週六或週日的航班從密爾沃基	飛行
最廉價的來回機票，從塔科馬到奧蘭多	飛行
我需要從多倫多到圣迭戈加拿大航空飛行與DC短暫停留	機票
列出每天從丹佛飛往巴爾的摩的航班	飛行
我想從底特律飛往聖。聖彼得堡的西北航空公司和亂放上午9時告訴我這個航班使用什麼飛機，並告訴我航班號	飛行
什麼航班有從達拉斯到匹茲堡在星期一早上	市
有沒有從丹佛飛往亞特蘭大的航班任何在匹茲堡站	飛行
什麼呢IAH平均	飛行
我想從匹茲堡最晚的時間內飛到亞特蘭大對我們的空氣，晚上	縮寫
讓我從多倫多所有航班	飛行
I'd像Continental Airlines從華盛頓到費城的航班信息	飛行
列出從奧克蘭每天飛往波士頓的航班使用達美航空公司	飛行
告訴我從費城到波士頓週一該服務一頓飯，中午前到達所有航班	飛行
上週三上午從什麼匹茲堡飛往亞特蘭大的航班提供早餐	飛行
我想從亞特蘭大到華盛頓特區週三航班	飛行
哪些城市呢歐陸服務	飛行
從列出鳳密爾沃基所有的美國航空公司航班上週三	市
什麼地面交通舊金山可用	飛行
列出從丹佛飛往舊金山的航班下午2點在週一之後	飛行
告訴我所有的達美航空公司和TWA是去亞特蘭大早上航班	飛行
我想從巴爾的摩去舊金山，丹佛停留	飛行
請給我從波士頓飛往匹茲堡的航班下週的週三	飛行
讓我從舊金山到達拉斯的航班	飛行
什麼地面交通在巴爾的摩可用	飛行
顯示來自丹佛的航班到舊金山	飛行
是什麼從波士頓到舊金山航班	飛行
週日的坦帕和山貓之間的航班	飛行
告訴我從巴爾的摩到達拉斯的航班	飛行
什麼航空公司從伯班克飛往丹佛	飛行
列出從芝加哥到西雅圖的所有航班歐陸其出發週六開飯	航空公司
列出所有離開丹佛在西雅圖港航班上週六下午1230後出發	飛行
你如何從機場到達拉斯市中心獲取請	飛行
請列出從亞特蘭大到ST週二航班。路易	飛行
我想從洛杉磯到夏洛特週一早上早航班	飛行
從拉斯維加斯到蒙特利爾週六航班	飛行
讓我看看波士頓地面交通	飛行
告訴我從紐約到邁阿密頭等艙往返航班，我想最廉價的頭等艙票價請	飛行
請列出從匹茲堡飛往巴爾的摩到達五七航班	飛行
做航空公司還提供一流	飛行
我需要知道，如果有從ST任何直航。聖彼得堡佛羅里達州塔科馬華盛頓最好明天早上離開	航空公司
有多少是我們的空氣波士頓飛往匹茲堡的每日直達航班	飛行
I'd喜歡從哥倫布預訂航班飛往納什維爾的請	機票
什麼從底特律到ST航班。聖彼得堡	飛行
什麼航空公司從達拉斯飛往巴爾的摩	飛行
什麼是從巴爾的摩到費城這些航班的成本	航空公司
告訴我，通過亞特蘭大去三角洲航班	機票
列出在週日下午的航班從奧克蘭飛往達拉斯	飛行
告訴我從達拉斯到休斯敦最早的直飛航班	飛行
我想從匹茲堡到午夜奧克蘭旅遊能給我的航班	飛行
告訴我從波士頓到舊金山航班	飛行
哪些城市是美國航空服務	飛行
有一個傍晚飛離華盛頓，丹佛	市
我需要一個頭等艙機票從達拉斯飛往舊金山	飛行
讓我知道從亞特蘭大到巴爾的摩直飛	機票
讓我從舊金山到匹茲堡週一航班	飛行
請告訴我從邁阿密到紐約的回程航班	飛行
讓我從舊金山到費城的特價機票	飛行
告訴我從亞特蘭大到華盛頓特區的所有航班價格	飛行
給我從匹茲堡飛往巴爾的摩的航班	機票
發現從巴爾的摩的往返航班飛往匹茲堡的行程安排	飛行
沒事，你讓我知道飛機聯合航空公司類型是使用從丹佛到舊金山的航班我想知道飛機的類型，他們在早晨對這些航班使用10日前	飛行
告訴我從費城飛往達拉斯的航班	飛機
什麼是最早的航班我可以從巴爾的摩到波士頓	飛行
巴爾的摩視頻	飛行
您好，我需要從辛辛那提到加利福尼亞州聖何塞去下午6時後，星期六	飛行
什麼是波士頓和華盛頓之間的最早的航班的航班號	飛行
有沒有對我們的空氣亞特蘭大週三任何航班從匹茲堡	航班號
你有沒有在波士頓機場與市區之間的地面交通	飛行
在丹佛中轉所有航班西北	飛行
I'd希望得到從華盛頓到奧克蘭航班在達拉斯 - 沃斯堡停留於九月十五	飛行
是匹茲堡和波士頓之間存在週三上午航班	飛行
什麼是頭等艙機票的往返費用從波士頓到舊金山	飛行
什麼才是從達拉斯到任何一個城市的最低往返票價	機票
今天一早給我從波士頓到舊金山離開航班	機票
在奧克蘭地面交通	飛行
告訴我從費城到舊金山的所有航班在達拉斯一站式	飛行
何夕航班你們有從巴爾的摩到費城	飛行
告訴我從洛杉磯到匹茲堡週二航班	飛行
什麼是從任何一個城市到另一個最便宜的單程票價	飛行
I'd喜歡尋找從夏洛特到拉斯維加斯的航班，並在ST停止。路易	機票
我住在丹佛和I'd喜歡做一個前往匹茲堡	飛行
列出從巴爾的摩到亞特蘭大的所有航班後，12日中午	飛行
讓我從舊金山最便宜的單程飛行到波士頓離開舊金山晚上9點以後	飛行
給我從波士頓到費城下週午餐後抵達的所有航班	飛行
是什麼從丹佛飛往費城週六所有航班	飛行
從丹佛一月十三至舊金山航班信息	飛行
I'd喜歡找最便宜的單程票價從巴爾的摩飛往丹佛	飛行
我需要從長灘到哥倫布在週日航班	機票
什麼是票價從夏洛特到紐瓦克在週二和週三航班	飛行
告訴我從波士頓到丹佛轉機，在上午10點離開波士頓的行程	機票
找我從亞特蘭大到巴爾的摩航班	飛行
是什麼，從亞特蘭大到費城的航班和票價	飛行
我想從紐約到拉斯維加斯二月第二十八清晨的直飛航班	航班機票+
形容票價代碼QX	飛行
什麼是上週五到舊金山最早的航班從華盛頓	縮寫
從芝加哥到洛杉磯早上美國航班	飛行
顯示從匹茲堡飛往奧克蘭的所有航班	飛行
列出從芝加哥到美國大陸航空公司西雅圖其離開上週六中午之前，包括一頓飯的所有航班	飛行
我想在3月首次飛行到休斯敦達拉斯第一和來自休斯頓的最後一個航班到達拉斯3月首次	飛行
請給我丹佛地面交通信息	飛行
是什麼從芝加哥飛往印第安納波利斯的航班	飛行
告訴我對我們的飛行3357從費城到巴爾的摩票價	飛行
第一類價格舊金山匹茲堡往返	機票
什麼航班有從明尼阿波利斯飛往芝加哥	機票
現在好了，我需要從西雅圖到聖地亞哥航班	飛行
什麼是你在八月第二十七從華盛頓到波士頓的最後一趟	飛行
我想離開華盛頓四月二十到亞特蘭大最便宜的票價	飛行
給我頭等艙機票從巴爾的摩到達拉斯	飛行
I'd喜歡從克利夫蘭飛往印第安納波利斯明天早上儘早什麼才是可用	機票
我需要做一個旅程開始在波士頓去達拉斯丹佛奧克蘭和返回波士頓	飛行
哪些航班可以從波士頓到丹佛週三清晨	飛行
我想要從華盛頓到舊金山和返回的往返航班	飛行
在上午10點前，飛行從丹佛飛往舊金山的美國聯合航空公司使用什麼類型的飛機	飛行
從舊金山最低票價洛杉磯	飛行
什麼航班從費城到達拉斯，在亞特蘭大短暫停留	機票
告訴我從巴爾的摩到奧克蘭航班	飛行
什麼呢碼QW平均	飛行
在那裡，從紐約到加拿大蒙特利爾留下任何週四航班	縮寫
告訴我，從奧克蘭到費城上週六其端出的所有航班	飛行
列出從西雅圖大陸430點之後，離開所有航班	飛行
I'd像波士頓最早的航班信息舊金山一餐	飛行
什麼是從匹茲堡到亞特蘭大留在十月初五最便宜的航班	飛行
告訴我從亞特蘭大到華盛頓特區在週三晚上和週四上午的航班	飛行
從密爾沃基飛往奧蘭多的航班單程	飛行
告訴我關於六月第二十九從達拉斯到舊金山的美國航空公司航班	飛行
請告訴我在週二從舊金山飛往匹茲堡的航班	飛行
航班信息從舊金山到匹茲堡	飛行
顯示我的所有到達達拉斯的航班	飛行
告訴我從丹佛飛往華盛頓在週三航班	飛行
波士頓和亞特蘭大之間飛什麼航線	飛行
我想從波士頓飛往巴爾的摩什麼時間是在下午的航班	航空公司
請解釋票價碼f	飛行
我想12後，中午就知道從長灘到哥倫布在六月十五航班，請	縮寫
列出從巴爾的摩或丹佛或匹茲堡休假的所有航班，並在抵達費城	飛行
什麼是服務於漢莎航空類	飛行
告訴我從巴爾的摩到波士頓的航班	飛行
還好我'd喜歡在這一個做的是從華盛頓去亞特蘭大，我想一個不停和我'd似的離開下午5點左右	飛行
給我從亞特蘭大到巴爾的摩航班	飛行
告訴我從蒙特利爾飛往費城的航班	飛行
請列出從丹佛飛往費城的所有航班從現在起星期六	飛行
確實飛行DL 323 DL 229從波士頓到費城丹佛停止	飛行
讓我從辛辛那提的航班	飛行
是什麼航班將在七月初七早上從亞特蘭大到波士頓使用	飛行
請給我從丹佛飛往匹茲堡它在早晨離開在7月2日的航班	飛行
讓我知道從巴爾的摩奧克蘭和波士頓抵達丹佛的航班	飛行
做任何的舊金山飛往波士頓的航班上週五離開	飛行
現在我需要的航班將在丹佛下午在週三和到達舊金山	飛行
我想從亞特蘭大前往丹佛週二	飛行
沒有美國航空公司飛從費城飛往達拉斯	飛行
從夏洛特出發前往紐瓦克什麼的飛行，那假在下午或休假，晚上	飛行
在那裡達拉斯週一下午任何可用的航班從巴爾的摩	飛行
什麼樣的地面交通丹佛可用	飛行
從威徹斯特縣飛往舊金山的每日航班	機票
我需要找到從費城到舊金山的航班是在達拉斯停留	飛行
找我從波士頓到舊金山的航班在丹佛短暫停留	飛行
告訴我從匹茲堡飛往達拉斯的航班	飛行
告訴我從亞特蘭大到華盛頓特區週三晚上航班	飛行
顯示從丹佛飛往舊金山的航班	飛行
什麼是由達美航空公司服務的城市	飛行
什麼航班有從亞特蘭大到華盛頓早期在星期四的早晨	市
列出所有從匹茲堡飛往費城國際	飛行
I'd像ST公司的航班。聖彼得堡邁阿密對下週四	飛行
告訴我從紐約所有飛往邁阿密的航班上留下一個星期二	飛行
我想從亞特蘭大飛往費城直達	飛行
什麼是從匹茲堡飛往巴爾的摩到達五七最小的飛機	飛行
從什麼孟菲斯飛往邁阿密的航班上週三	飛機
從鳳凰城到芝加哥在週三對美國航班	飛行
匹茲堡亞特蘭大請在沃斯堡停留	飛行
告訴我鳳凰和鹽湖城之間的往返航班	飛行
沒有任何一家航空公司有從波士頓到丹佛的早期下午的航班	飛行
列出的從波士頓到費城達美航空公司航班票價	航空公司
請給我一個航班離開波士頓前往華盛頓抵達華盛頓5點鐘，下午	機票
需要從巴爾的摩飛往舊金山的航班便宜	飛行
我想從紐約的往返票價聖荷西	飛行
什麼時候不從華盛頓傍晚的航班離開丹佛	機票
定義UA航空公司	飛行時間
飛行週一從費城到加利福尼亞州奧克蘭清晨	縮寫
讓我從舊金山到匹茲堡週二航班	飛行
告訴我從丹佛飛往費城國際	飛行
我想從巴爾的摩飛往TWA舊金山	飛行
從夏洛特到任何地方的所有航班上我們的空氣	飛行
讓我知道從波士頓飛往底特律的航班	飛行
我想明天和停止從克利夫蘭飛往聖地亞哥在印第安納波利斯	飛行
從波士頓到華盛頓特區的所有航班上月的第十	飛行
其實我是想通過芝加哥從安大略到威徹斯特	飛行
我需要從堪薩斯城到芝加哥飛離開在下週三和返回的第二天	飛行
告訴我從費城到亞特蘭大星期三下午五時後留下的所有航班	飛行
給我看在丹佛平日地面交通	飛行
該航空公司有從丹佛飛往匹茲堡的航班	飛行
是什麼從孟菲斯到塔科馬的航班	航空公司
我們不會從空氣直流飛到達拉斯	飛行
是什麼從亞特蘭大到巴爾的摩其在下午7時抵達巴爾的摩的航班	飛行
我需要從紐約到蒙特利爾週四飛行可能中午前6到達	飛行
哪些呢票價代碼QX平均	飛行
有沒有與達拉斯 - 沃斯堡停留舊金山和波士頓之間的航班	縮寫
從亞特蘭大到華盛頓航班	飛行
什麼樣的飛機是從波士頓到舊金山下午最早的航班使用	飛行
從印第安納波利斯飛往西雅圖的航班	飛機
達拉斯到巴爾的摩週一	飛行
是票價代碼B一樣商務艙	飛行
並中西部快捷服務納什維爾	縮寫
從印第安納波利斯納什維爾孟菲斯飛往西雅圖的航班	飛行
I'd喜歡飛行明天晚從納什維爾到休斯敦晚餐請	飛行
給我從匹茲堡飛往波士頓的航班單程	飛行
我想從亞特蘭大到華盛頓特區的航班，我想上午9點前下午4點後，週四留下週三信息	飛行
我想從匹茲堡到亞特蘭大最便宜的航班	飛行
告訴我從多倫多到鹽湖城其中6點以後離開多倫多的航班	飛行
什麼是從巴爾的摩到舊金山週五八月三十最便宜的機票	飛行
讓我知道從辛辛那提到多倫多航班	機票
什麼時間是從丹佛飛往舊金山的航班上美國大陸航空公司	飛行
怎麼樣從達拉斯到亞特蘭大週三早上航班	飛行時間
多久是從費城機場費城市中心一趟	飛行
有多少在734個席位	距離
有關於東航從波士頓到丹佛航班	容量
從拉斯維加斯到紐約直飛TWA和票價	飛行
讓我知道從費城到辛辛那提的航班	飛行
從華盛頓到舊金山的所有航班2後離開	飛行
I'd喜歡從華盛頓飛往美國聯合航空公司丹佛	飛行
告訴我從邁阿密到紐約的所有航班	飛行
給我從匹茲堡飛往巴爾的摩的航班	飛行
告訴我從匹茲堡飛往巴爾的摩其中下午3點以後離開週四的所有航班	飛行
我需要從亞特蘭大到北卡羅萊納州夏洛特下週一航班	飛行
什麼地面交通有從丹佛	飛行
我想從波士頓到丹佛在丹佛到達日上午9點星期三早上或9點星期三早上航班	飛行
讓我從圣迭戈到邁阿密一種方式最便宜的票價	飛行
告訴我美國的航班從波士頓到華盛頓特區	機票
I'd想知道從波士頓到佐治亞州亞特蘭大最早航班	飛行
告訴我從紐約到邁阿密留在一個星期二的所有航班，並告訴我從邁阿密的所有航班到紐約留下週日	飛行
什麼是EWR	飛行
我希望看到從亞特蘭大到巴爾的摩最便宜的航班	縮寫
什麼航班有從紐約到拉斯維加斯	飛行
找我從波士頓到丹佛最早的航班，供應早餐	飛行
對美國一流飛往舊金山下星期二	飛行
告訴我從波士頓到丹佛的所有航班	飛行
什麼地面交通在明尼阿波利斯可用	飛行
有沒有可從匹茲堡機場豪華轎車服務	飛行
費城到舊金山週一	飛行
什麼都在波士頓和奧克蘭之間最便宜的單程票價的限制	飛行
從華盛頓到費城飛行清晨倍，美國的航空航班信息	限制
告訴我從巴爾的摩到達拉斯所有可用的航班經濟艙票價	飛行
巴爾的摩費城	飛行
是否有任何其他的城市，我可以從波士頓飛往達拉斯通過，我可以在早晨起床航班早於1017	飛行
我需要的航班信息離開亞特蘭大和巴爾的摩抵達星期一	市
從丹佛列表發車時間到費城這是晚於10點和早於下午2點	飛行
告訴我從巴爾的摩到奧克蘭的最新航班晚餐	飛行時間
在奧克蘭地面運輸	飛行
哪些呢票價代碼QO平均	飛行
並中西部快捷服務印第安納波利斯	縮寫
列出從亞特蘭大到巴爾的摩週四上午的所有航班	飛行
讓我從沃思堡丹佛的美國航空公司航班上的7月11日的晚上	飛行
什麼地面交通可在亞特蘭大機場	飛行
列出從邁阿密到克利夫蘭我們所有空氣的航班將在週日下午	飛行
請列出從達拉斯飛往匹茲堡的所有航班七月四日1991	飛行
給我從邁阿密到紐約使用塔空氣的航班	飛行
不航班DL 1083從費城到丹佛飛星期六	飛行
有哪些不同類型的服務和價格對我們的空氣	飛行
我想一個航班從波士頓到達舊金山在亞特蘭大停留離開	機票
什麼是從孟菲斯到拉斯維加斯最早的航班	飛行
I'd想有航班從丹佛飛往匹茲堡	飛行
告訴我第一德爾塔航空公司飛行類	飛行
什麼是供應早餐匹茲堡和丹佛之間的最早的航班	飛行
好吧，我想從亞特蘭大飛往費城	飛行
找到下午10時前，從巴爾的摩的往返航班匹茲堡下午8時之後的行程安排	飛行
我想從波士頓飛往費城下週四	飛行
從舊金山最低票價奧蘭多	飛行
你可以請找我從波士頓到奧克蘭最早的航班	機票
你可以了解在亞特蘭大可用的地面交通	飛行
波士頓和舊金山之間各航空公司飛什麼是最早的航班	飛行
列出所有華盛頓和丹佛之間飛行的航空公司	飛行
什麼是對大陸1291往返票價從丹佛飛往舊金山和回報	航空公司
從紐約到拉斯維加斯直飛航班上週日	機票
什麼是最早的航班離開丹佛和美國聯合航空公司在巴爾的摩抵達一流的七月四日	飛行
我需要從波士頓去丹佛，然後到舊金山	飛行
確實有東部從波士頓到舊金山午後飛行	飛行
讓我看看華盛頓附近的機場	飛行
給我從丹佛飛往巴爾的摩的航班	飛機場
什麼從鳳凰城到拉斯維加斯的航班上週六	飛行
告訴我出今天波士頓的所有航班	飛行
什麼是票價代碼F平均	飛行
從什麼伯班克到密爾沃基的航班離開伯班克的明天	縮寫
其中週二3和5點之間抵達波士頓和費城的特價機票	飛行
告訴我，從亞特蘭大到波士頓航班	飛行
我需要一個航班亞特蘭大今天下午	飛行
什麼是從舊金山去的一種方式來奧克蘭十一月十七票價	飛行
有大陸航班從拉斯維加斯離開紐約直飛	機票
告訴我從紐約所有一流的票價邁阿密留下一個星期二	飛行
I'd喜歡從聖地亞哥到多倫多航班在阿拉斯加航空公司下午1時左右離開	機票
什麼是UA	飛行
顯示我的所有一流的價格從達拉斯到巴爾的摩	縮寫
從克里夫蘭到邁阿密的航班	機票
達拉斯地面交通	飛行
告訴我從亞特蘭大到巴爾的摩航班	縮寫
列出週三的所有航班會從波士頓到亞特蘭大下午6點後	飛行
什麼航班做你已經離開波士頓去舊金山	飛行
給我從亞特蘭大到華盛頓特區0900臨走週四航班信息	飛行
是什麼從亞特蘭大到波士頓在下午的航班	飛行
你有沒有從鹽湖城到ST飛行。聖彼得堡	飛行
我想從波士頓到丹佛的航班，在匹茲堡停止	飛行
我感興趣的最低票價從華盛頓到沃斯堡	飛行
列出在米切爾將軍國際的所有航班	機票
列出從紐約到拉斯維加斯是從孟菲斯到拉斯維加斯週日和列表航班，週日直飛直飛航班全部	飛行
什麼呢EWR平均	飛行
告訴我從舊金山飛往匹茲堡的航班在星期一是一流的	縮寫
我想在提前一天飛到舊金山	飛行
給我丹佛和奧克蘭之間的航班??列表	飛行
什麼是一天離開達拉斯舊金山最新的頭等艙飛行	飛行
什麼才是最新的航班上，我可以從達拉斯到波士頓	飛行
I'd喜歡對從丹佛飛往亞特蘭大的車票的一些信息在匹茲堡停止	飛行
什麼是達拉斯和巴爾的摩之間的最廉價的飛行教練離開八月十	機票
你必須在645上午前往華盛頓起飛的航班波士頓	飛行
請列出從密爾沃基到聖何塞週三美國航空公司航班	飛行
I'd喜歡留在亞特蘭大下午在費城下午5時抵達	飛行
有沒有從巴爾的摩飛往舊金山與TWA在丹佛停止	飛行
什麼是我的餐點從波士頓到丹佛	飛行
I'd喜歡從波士頓去匹茲堡找到最便宜的航班	膳食
你有沒有從波士頓到華盛頓美聯航航班	飛行
距離達拉斯機場到達拉斯市中心有地面交通	飛行
從邁阿密到紐約的所有航班	航班機票+
波士頓和奧克蘭之間的名單可能往返航班，每天	飛行
什麼呢EWR平均	飛行
列出從奧蘭多到堪薩斯城的最便宜的往返航班	縮寫
你可以列出從多倫多到聖地亞哥的所有航班	飛行
我可以採取什麼樣的地面運輸到波士頓	飛行
什麼是從波士頓到華盛頓的航班最早於八月第二十七	飛行
列出從奧蘭多飛往堪薩斯城的往返航班	飛行
我想在早晨華盛頓你們最早的航班從費城美國航空公司的時間	飛行
請告訴我，波士頓和費城下週四之間的航班	飛行時間
讓我知道從丹佛是中午前後到達巴爾的摩的航班，並從邁阿密的所有航班	飛行
讓我看看波士頓和丹佛之間的航空公司	飛行
該航空公司通過其他城市從波士頓飛往華盛頓	航空公司
我需要知道從亞特蘭大航班列表	航空公司
我可以帶一個航空公司從洛杉磯到夏洛特紐瓦克回到洛杉磯	飛行
該航空公司提供匹茲堡	航空公司
從亞特蘭大機場到亞特蘭大市中心有交通	航空公司
告訴我，從圣迭戈到紐瓦克的休斯頓方式航班	航空公司
給我一份有票價上月第二十七個從印第安納波利斯到奧蘭多航班	飛行
I'd像巴爾的摩返程航班波士頓	飛行
我需要從舊金山到匹茲堡，然後匹茲堡到紐約飛行和紐約到舊金山	飛行
什麼是最後一個航班亞特蘭大從巴爾的摩	飛行
七月十三對美國早期的航班從費城到舊金山	飛行
讓我從聖地亞哥到舊金山西南航空公司的所有航班	飛行
請你告訴我丹佛和達拉斯之間的所有航班工作日	飛行
列出使用美國航空公司的奧克蘭和波士頓之間的所有的每日航班	飛行
列出所有從亞特蘭大到費城的航班八月第一	飛行
列表類型飛機的連接波士頓和舊金山	飛行
我需要從費城到丹佛航班	飛機
什麼樣的限制AP68	飛行
給我頭等艙機票從巴爾的摩到達拉斯	限制
我想從巴爾的摩美國航空公司飛往舊金山	機票
從辛辛那提到美國休斯敦飛行4400	飛行
我需要從紐約市到蒙特利爾週四飛行可能6	飛行
我想預定在下午晚些時候首先從洛杉磯到匹茲堡月飛行	飛行
第一像I'd從費城飛到達拉斯和從達拉斯飛到舊金山	飛行
告訴我從紐約飛往邁阿密的航班	飛行
告訴我從愛場離開航班	飛行
I'd喜歡購買經濟艙機票從丹佛飛往亞特蘭大的航班	飛行
我想從費城到舊金山的航班	機票
是什麼從舊金山到費城的所有航班在匹茲堡站	飛行
有多少是來自華盛頓的經濟艙機票到舊金山九月三十	飛行
巴爾的摩和華盛頓之間的航班	機票
什麼是票價從波士頓前往達拉斯 - 沃斯堡十一月十七一種方式	飛行
讓我從鳳凰城的所有航班密爾沃基下週三	機票
請列出從多倫多到華盛頓的航班	飛行
所有飛往舊金山的航班離開華盛頓特區是一流的	飛行
我想知道從丹佛飛往奧克蘭最便宜的方式	飛行
告訴我從波士頓飛往丹佛的航班早在星期二上午	飛行
告訴我從紐約到邁阿密在週二與往返車費932下的所有美元航班	飛行
I'd像從丹佛飛往舊金山的航班上聯合航空信息	飛行
告訴我從亞特蘭大到丹佛週一航班	飛行
告訴我從波士頓飛往匹茲堡的航班	飛行
什麼航班，明天有從塔科馬到聖何塞	飛行
告訴我從達拉斯到巴爾的摩的特價機票	飛行
告訴我從費城到巴爾的摩的航班	飛行
列出所有航空公司該服務丹佛	飛行
什麼是豪華轎車服務在洛根機場的費用	航空公司
紐約和邁阿密之間的所有往返航班是頭等艙	飛行
什麼才是從BWI最低往返票價任何城市	飛行
I'米從丹佛開始	機票
讓我從舊金山亞特蘭大和匹茲堡達拉斯的所有航班	飛行
什麼才是從聖何塞到休斯敦的最新航班	飛行
告訴我往返機票從巴爾的摩到亞特蘭大	飛行
美聯航在丹佛停止	機票
我就需要租車在亞特蘭大機場，你可以告訴我什麼是可用	飛行
什麼樣的地面交通。有一次我到達拉斯	飛行
我想從亞特蘭大飛往丹佛九月十五	飛行
在7月24日三分之一的美國航空公司飛往舊金山的航班從費城	飛行
告訴我明天從舊金山飛往匹茲堡的所有航班	飛行
什麼是從坦帕到密爾沃基明天最早的航班	飛行
我需要從紐瓦克飛往坦帕上週五航班	飛行
I'd喜歡再看到票價代碼QX	飛行
租賃汽車在華盛頓特區	縮寫
坦帕和ST之間的航班??。路易	飛行
告訴我在西雅圖的地面運輸	飛行
哪些航班可以從匹茲堡飛往波士頓上週六	機票
什麼航班都可以週六從達拉斯舊金山	飛行
告訴我從丹佛飛往巴爾的摩或華盛頓之前或中午前後到達航班	飛行
請列出飛行時間從紐瓦克飛往波士頓	飛行
什麼是票價亞特蘭大和DFW之間的航班	飛行時間
從費城到舊金山週四航班列表	機票
並中西部快捷服務巴爾的摩	飛行
我想丹佛飛往匹茲堡	飛行
我要飛從達拉斯到費城	飛行
告訴我從亞特蘭大到奧克蘭是留在下午和晚上430和630點之間到達的直飛航班	飛行
請列出所有航班西北到丹佛	飛行
秀達拉斯航班頭等艙的美國費城	飛行
什麼是這些航班的價格	飛行
我想知道我可以從華盛頓到舊金山的最新航班的時間在那裡我能得到一頓晚飯	機票
告訴我從丹佛飛往舊金山週三航班	飛行時間
告訴我田納西州孟菲斯和拉斯維加斯之間的航班	飛行
有來自匹茲堡週四晚上飛往舊金山的美國空氣	飛行
I'd想訂於七月二十從匹茲堡到亞特蘭大最便宜的單程航班	飛行
列出所有從納什維爾飛往西雅圖的航班	飛行
什麼是由美國航空公司提供亞特蘭大和DFW之間的航班??票價	飛行
是什麼從費城週日丹佛的所有航班	機票
有多少航班舊金山和費城之間是存在於八月十八	飛行
我想預訂機票，從孟菲斯前往拉斯維加斯	數量
什麼地面交通可從匹茲堡機場鎮	飛行
從紐約市飛往蒙特利爾的航班	飛行
有多少是從丹佛飛往匹茲堡最便宜的航班	飛行
該航空公司提供華盛頓和丹佛之間的直飛航班	機票
描述在達拉斯地面交通	航空公司
什麼是從波士頓到丹佛航班的成本	飛行
從坦帕何去何從航班夏洛特週日	機票
什麼航班確實美國航空公司有從波士頓到達拉斯	飛行
票價從達拉斯到巴爾的摩	飛行
早上的飛機從達拉斯到亞特蘭大	機票
在那裡，從費城到丹佛任何的直飛航班是下午5點之前到達	飛行
什麼是EWR	飛行
該航班波士頓和巴爾的摩華盛頓之間	縮寫
請給我從丹佛飛往巴爾的摩的美國聯合航空公司航班是頭等艙機票，請	飛行
飛機的類型從費城首飛到達拉斯早晨用什麼	飛行
什麼交通可從達拉斯機場到市區	飛機
什麼是最早的航班離開波士頓前往華盛頓九月第三	飛行
告訴我，飛從舊金山到波士頓的航空公司	飛行
從夏洛特到我們去任何地方的所有機票Air下午1點左右	航空公司
該航空公司有堪薩斯城芝加哥的直飛航班	飛行
我需要從芝加哥到達拉斯六月十五航班上大陸	航空公司
從納什維爾飛往西雅圖的航班	飛行
什麼三角洲離開波士頓亞特蘭大	飛行
告訴我，從亞特蘭大到匹茲堡最廉價的單程航班	飛行
列出所有在米切爾將軍國際到達從各城市的航班	飛行
請列出在匹茲堡汽車租賃信息	飛行
哪些航班可星期四下午從巴爾的摩到亞特蘭大	機票
告訴我達拉斯飛往波士頓的航班	飛行
我需要一個航班離開匹茲堡下週一在沃思堡上午抵達前10	飛行
什麼航空公司從波士頓飛往舊金山	飛行
告訴我，從奧克蘭到達拉斯在週日航班	航空公司
告訴我飛行的EA 212的從亞特蘭大價格華盛頓	飛行
什麼航班有從亞特蘭大到奧克蘭週四在飛機餐	機票
是什麼從丹佛飛往匹茲堡的最便宜的往返航班	飛行
是什麼密爾沃基到奧蘭多航班上週三	飛行
我需要從多倫多到蒙特利爾的航班上週五凌晨到達蒙特利爾	飛行
告訴我從達拉斯到巴爾的摩航班	飛行
什麼地面交通丹佛可用	飛行
大約在下午12和4之間在匹茲堡抵達東航航班什麼	飛行
從匹茲堡何去何從飛往紐瓦克305後，在下午	飛行
什麼是從波士頓到舊金山航班的成本	飛行
我想從巴爾的摩到達拉斯在星期二清晨航班信息	機票
我感興趣的一個航班從匹茲堡飛往亞特蘭大	飛行
告訴我從紐瓦克飛往西雅圖最早的航班	飛行
你能告訴我什麼早晨航班從奧克蘭到丹佛上午10點前	飛行
波士頓匹茲堡週三	飛行
從巴爾的摩和華盛頓任何在丹佛停留要去舊金山	飛行
什麼是舊金山和波士頓之間提供的最新飛行	飛行
給我最新的航班明天American Airlines從密爾沃基到塔科馬	飛行
你從費城有一到丹佛	飛行
什麼是從克里夫蘭到印第安納波利斯的航班上週三可能第十二在任TWA三角洲或大陸	飛行
從多倫多到亞特蘭大下午	飛行
告訴我從丹佛飛往亞特蘭大的航班	飛行
來自達拉斯的所有航班和票價	飛行
什麼是從波士頓車費舊金山聯合航空公司航班21	航班機票+
找到從波士頓到舊金山最便宜的單程票價	機票
顯示我的所有到達從其他機場的愛情領域航班	機票
從列出亞特蘭大北卡羅萊納州夏洛特即離開下週一所有航班	飛行
上月第三十一個波士頓和亞特蘭大之間的航班??是什麼	飛行
我想從波士頓到丹佛TWA航班	飛行
我想從洛杉磯到匹茲堡航班下午3點前到達週二	飛行
美國匹茲堡771到費城是什麼票價	飛行
讓我在7月24日首先在從波士頓晚上DC提供的最後一次飛行	機票
我想，上午10點前抵達巴爾的摩從匹茲堡到巴爾的摩週四航班列表	飛行
我想從華盛頓一個下午的航班波士頓八月二十	飛行
列出從奧蘭多飛往堪薩斯城的所有往返航班	飛行
讓我離開費城下午，抵達晚上在丹佛的航班	飛行
告訴我從華盛頓到波士頓的航班下午	飛行
什麼地面交通有亞特蘭大	飛行
該航班離開伯班克中午後在丹佛下午6時抵達	飛行
費城飛往達拉斯週六	飛行
我想在早晨波士頓和華盛頓之間早點去	飛行
舊金山匹茲堡週五	飛行
顯示從巴爾的摩到達拉斯其中下午4點以後留下的所有航班	飛行
從紐瓦克新澤西飛往克里夫蘭的航班	飛行
I'd喜歡再看到從丹佛飛往費城的航班	飛行
我想就從丹佛飛往舊金山週三中午航班信息後	飛行
航班從達拉斯到密爾沃基	飛行
飛從達拉斯到巴爾的摩	飛行
告訴我，當天下午離開從費城飛往丹佛的航班列表	飛行
讓我從丹佛是去匹茲堡，然後亞特蘭大的航班	飛行
讓我從舊金山到波士頓的航班	飛行
請列出丹佛和波士頓之間只有團結航空公司航班	飛行
什麼才是從亞特蘭大到BWI最低往返票價	飛行
哪些呢限制美聯社57均值	機票
我需要從匹茲堡到紐約航班	縮寫
我期待從印第安納波利斯飛往奧蘭多的最低票價在十二月第二十七	飛行
什麼航班離開北卡羅萊納州夏洛特，並在亞利桑那州鳳凰城下午4點之前到達星期一	機票
亞特蘭大和波士頓之間的票價	飛行
顯示在丹佛地面交通	機票
什麼是航班的航班號，其通過印第安納波利斯從舊金山前往華盛頓	飛行
什麼是從波士頓最晚一班車到匹茲堡在七月第七	航班號
從亞特蘭大到華盛頓特區的航班上週四上午	飛行
什麼航班可以從匹茲堡找到舊金山上午9點之後	飛行
讓我從圣迭戈到紐瓦克的航班	飛行
從達拉斯到丹佛的航班什麼下午3點之後	飛行
從紐瓦克飛往克利夫蘭的每日航班	飛行
你有沒有從芝加哥飛往印第安納波利斯的任何航班	飛行
你有沒有從波士頓9點鐘飛往費城	飛行
什麼級別的服務確實有TWA	飛行
什麼航班你們有從丹佛達拉斯和匹茲堡到巴爾的摩	飛行
沒有任何一家航空公司有匹茲堡和巴爾的摩之間的飛機飛行	飛行
讓我從ST的航班。聖彼得堡鹽湖城當天中午之前到達	航空公司
什麼是最早的航班離開華盛頓到舊金山	飛行
是否有波士頓和達拉斯之間的任何美國聯合航空公司航班	飛行
什麼從聖航班。保羅堪薩斯城上週五隨餐	飛行
我想在大陸航空公司離開加利福尼亞州舊金山抵達賓夕法尼亞州匹茲堡航班	飛行
告訴我從丹佛飛往費城在週一航班	飛行
告訴我，從亞特蘭大到夏洛特下週一航班	飛行
我可以看到所有從克里夫蘭到達拉斯的航班	飛行
前上午10波士頓丹佛所有航班	飛行
什麼是亞特蘭大和達拉斯之間最便宜的商務艙航班	飛行
該航班上有週二從舊金山飛往匹茲堡	飛行
是什麼從印第安納波利斯到聖地亞哥的航班上週三第十二屆	飛行
I'd喜歡找從佛羅里達州邁阿密到內華達州拉斯維加斯飛行，將在週日下午4點之前到達	飛行
我想從波士頓到亞特蘭大的航班	飛行
我將在亞特蘭大，你能告訴我要住市中心兩小時的地面交通是什麼	飛行
從市中心丹佛機場出現地面交通	飛行
告訴我到舊金山1之前抵達航班	飛行時間
是什麼費城的航班和票價從波士頓	飛行
請告訴我團結波士頓和舊金山之間的直飛航班在晚上出發約5	航班機票+
我希望有一個航班始發於丹佛去匹茲堡和亞特蘭大以任何順序	飛行
讓我從舊金山到達拉斯的航班，請	飛行
我想晚上9點以後就知道了可離開匹茲堡舊金山出來的航班上週四晚	飛行
什麼是票價代碼H	飛行
列出所有著陸在米切爾將軍國際	縮寫
所有從克里夫蘭到紐瓦克的航班	飛行
確實我們的空氣是從多倫多飛往鹽湖城週一可能第三十一部分	飛行
請告訴我，從亞特蘭大到丹佛的航班	飛行
什麼才是從波士頓到華盛頓國際最早的航班，供應晚餐	飛行
什麼時候的飛機離開波士頓	飛行
告訴我從休斯敦到達拉斯直飛航班	飛行
給我任何能告訴我什麼頭等艙票價從匹茲堡飛往舊金山的航班上週一	飛行
給我看在波士頓地面交通	機票
告訴我從巴爾的摩到奧克蘭航班	飛行
我想從多倫多到聖地亞哥航班，在堪薩斯城站	飛行
從ST TWA航班497766。聖彼得堡與一站式可用明天上午密爾沃基	飛行
請名單統一在上午9點離開波士頓和丹佛之間的航班	飛行
告訴我從克利夫蘭到孟菲斯的航班	飛行
什麼從鳳凰城到密爾沃基出發鳳美國航空公司的航班下午6點後，週三	飛行
什麼是從多倫多國際機場到多倫多的距離	飛行
在那裡有從費城到舊金山的航班在達拉斯站的航空公司	距離
告訴我地在舊金山交通	航空公司
美國航空公司從沃思堡得克薩斯州費城信息	飛行
給我所有從紐約到邁阿密的往返航班與成本低於466美元	飛行
什麼是各種飛機，曼聯航空使用的座位	飛行
下週三次日返回堪薩斯城芝加哥留下什麼航班	容量
什麼是最低票價從丹佛飛往匹茲堡	飛行
你可以列出我的航班，週日休假奧克蘭和抵達達拉斯	機票
我想之前在週二12點預訂從巴爾的摩到舊金山航班	飛行
從丹佛飛往舊金山下午	飛行
在我們的空氣	飛行
什麼是最便宜的單程票價從波士頓到舊金山	航空公司
距離達拉斯機場到達拉斯市中心的達拉斯有地面交通	機票
什麼才是最小的飛機從匹茲堡飛往巴爾的摩十二月十七	機票
告訴我頭等艙機票單程坦帕聖。路易	飛機
你能告訴我從納什維爾到休斯敦晚上航班服務於晚餐	飛行
現在我需要航班從亞特蘭大離開，並在週三上午到達費城	飛行
好吧聽起來不錯咱們從亞特蘭大去四月二一個早晨達拉斯最便宜的票價單程	飛行
什麼樣的地面運輸在達拉斯可用	飛行
顯示從休斯敦到達拉斯下午航班	飛行
你能告訴我從達拉斯機場到達拉斯市中心地面運輸安排	飛行
I'd像最低票價從丹佛匹茲堡	飛行
給我從丹佛巴爾的摩抵達航班	機票
從丹佛飛往巴爾的摩	飛行
從費城晚上7點到波士頓後留下什麼航班	飛行
我想波士頓飛往達拉斯	飛行
什麼美聯航頭等艙機票航班從丹佛到巴爾的摩月3	飛行
從鹽湖城到加州奧克蘭的航班	機票
在哪裡從波士頓到奧克蘭站的航班	飛行
地面交通亞特蘭大	飛機場
從波士頓到華盛頓特區的所有航班十一月十一	飛行
我想再次看到從巴爾的摩到費城的航班	飛行
我需要從印第安納波利斯到多倫多航班上週四早上到達多倫多	飛行
請告訴我從ST往返航班。聖彼得堡多倫多	飛行
顯示來自丹佛的航班到舊金山	飛行
什麼是最昂貴的單程票價從波士頓到亞特蘭大的美國航空公司	飛行
飛行價格從納什維爾飛往克里夫蘭	機票
我想從波士頓飛往奧克蘭從波士頓飛往奧克蘭什麼航空公司	機票
什麼航空公司的交流	飛行
匹茲堡巴爾的摩請一月一個	航空公司
航班從波士頓開始	飛行
是從亞特蘭大到費城的航班	飛行
什麼航班有從密爾沃基到上週六鳳	飛行
我該在亞特蘭大拿到一頓飯BWI飛行東部210	飛行
請告訴我從舊金山到匹茲堡週五的大陸航班	膳食
什麼才是從丹佛飛往匹茲堡最便宜的航班	飛行
列出從波士頓4點之間8抵達亞特蘭大的航班	飛行
沒有任何一家航空公司有一個下午的航班從亞特蘭大到波士頓	飛行
什麼出發飛往舊金山的航班下午4點後，並通過印第安納波利斯飛往華盛頓	航空公司
你能告訴我你每天有一個運行哪些航班從波士頓到舊金山，請	飛行
週二從費城到舊金山第二十三個航班上美國航空公司	飛行
請列出中午前離開丹佛西北航空公司的所有航班	飛行
什麼是可用的成本最低的機票從達拉斯到巴爾的摩航班抵達七月四日	飛行
你能告訴我什麼飛機用於飛行達1222堪薩斯城鹽湖城	機票
告訴我從達拉斯到巴爾的摩最廉價的往返	飛機
什麼車租賃從丹佛機場提供下星期天	飛行
什麼是在達拉斯的汽車租賃率	航空公司
什麼級別的服務做臨時工提供	機票
在ST存在地面運輸。路易	飛行
什麼是對大陸1291往返丹佛舊金山最廉價的往返車費	機票
多少的費用是從波士頓飛往亞特蘭大	機票
哪些城市美國和達美航空服務	機票
告訴我從費城到巴爾的摩的航班	市
哪些航班可以從波士頓到華盛頓下旬第二十五或早期第二十六	飛行
從列出米切爾將軍國際機場到達的航班和離開	飛行
沒事給我在上午飛行時間從匹茲堡九月二十舊金山	飛行
顯示從亞特蘭大飛往舊金山的所有直飛航班	飛行時間
列出所有從丹佛飛往費城國際	飛行
從波士頓單向飛往舊金山，請	飛行
我想從辛辛那提到伯班克的美國航空公司的航班離開這個下午	飛行
給我看在丹佛地面交通	飛行
什麼航班你今天從舊金山到匹茲堡	機票
告訴我從明尼阿波利斯至西雅圖7月2日航班	飛行
列出所有在米切爾將軍國際的起飛和著陸	飛行
讓我離開達拉斯到巴爾的摩航班	飛行
什麼是頭等艙機票從達拉斯成本舊金山	飛行
不American Airlines從費城飛往舊金山	機票
中午前就列出離開大陸丹佛和芝加哥抵達所有航班上週一	飛行
我想從納什維爾到ST飛行。路易到達聖。路易下午6點左右，並不停	飛行
並中西部快捷必須從蒙特利爾飛往納什維爾的任何航班。	飛行
從威徹斯特縣到ST航班。保羅	飛行
是什麼從納什維爾飛往塔科馬的航班在週二五月十八	飛行
I'd喜歡費用最便宜的票價從波士頓沃斯堡	飛行
什麼是最便宜的單程票價從波士頓到巴爾的摩	機票
可用週五下午航班什麼從匹茲堡飛往舊金山	機票
八月三十討好我的時間表上從丹佛飛往舊金山的航班清晨	飛行
從舊金山到亞特蘭大的航班上，我需要的信息，將停止在沃思堡	飛行
告訴我，低於1500元往返於達拉斯的所有航班	飛行
有多少乘客可以波音737保持	飛行
我需要從費城飛往達拉斯下週三航班在上午	容量
告訴我從戀愛外地的所有其他機場航班	飛行
什麼航空公司EA的縮寫	飛行
顯示美國航空公司出發地和目的地在亞特蘭大	航空公司
什麼航班從波士頓到巴爾的摩是最便宜的航班	飛行
從華盛頓到費城出發，下午	飛行
告訴我下午4點之後，從舊金山飛往丹佛的航班	飛行
I'd喜歡從明尼阿波利斯過兩天今天飛往長灘清晨	飛行
我需要從洛杉磯票夏洛特葉色清晨	飛行
我需要在地面交通西雅圖	機票
我要離開奧克蘭，並在波士頓在下午5點抵達	飛行
什麼是票價碼Y平均值	飛行
往返頭等艙機票紐約到邁阿密	縮寫
七月初七什麼是往返票的旅行對美國聯合航空公司從丹佛去巴爾的摩留下一流的成本	機票
可我從紐約到加拿大蒙特利爾星期三離開航班列表	機票
解釋票價代碼QX	飛行
什麼才是從匹茲堡到舊金山週五最便宜的航班	縮寫
請告訴我從丹佛飛往奧克蘭的航班票價全部	飛行
在華盛頓和舊金山之間的航班??是什麼	機票
什麼樣的飛機將我飛，如果我需要一個一流的美國航空公司航班從費城飛往達拉斯	飛行
你能告訴我時間飛行會從亞特蘭大離開波士頓，下午	飛機
I'd喜歡安排在一月一日前往巴爾的摩	飛行時間
什麼是在沃思堡得克薩斯州提供的地面交通	飛行
下午飛往達拉斯亞特蘭大	飛行
顯示從多倫多到圣迭戈美國航空的所有航班在鳳凰短暫停留	飛行
舊金山丹佛週二	飛行
告訴我從印第安納波利斯飛往休斯敦霍	飛行
告訴我從紐約所有飛往邁阿密的航班離開在星期二和返回上週日	飛行
您好我'd喜歡從坦帕到蒙特利爾航班	飛行
讓我從巴爾的摩的往返航班達拉斯最低票價	飛行
告訴我從費城到奧克蘭上週五航班	機票
給我的美國航空公司從達拉斯到舊金山的航班	飛行
I'd喜歡看到所有從波士頓到費城的航班	飛行
實際上是什麼從拉斯維加斯到伯班克的直飛航班上週六可22	飛行
告訴我從匹茲堡飛往舊金山的航班上週五中午12時後離開	飛行
什麼飛機共1209	飛行
解釋餐碼SD d	飛機
讓我在波士頓機場租車車費清單	縮寫
什麼是最便宜的航班今天從亞特蘭大飛往舊金山	飛行
告訴我從休斯敦到拉斯維加斯機票	飛行
什麼是最新的航班出發從波士頓到舊金山	機票
什麼是票價從巴爾的摩前往亞特蘭大的一種方式上月第七	飛行
請告訴我下午1時之後到舊金山週三來自丹佛的航班	機票
什麼航空公司代表馬力	飛行
請列出我的航班和他們的飛行從丹佛飛往巴爾的摩所有航空公司的成本	航空公司
我想從丹佛飛往亞特蘭大的航班	航班機票+
告訴我往返機票從巴爾的摩到達拉斯	飛行
地面交通舊金山	機票
我需要從亞特蘭大到費城飛行和我想找最便宜的票價	飛行
地面交通丹佛	飛行
解釋票價碼	機票
I'd想知道航班聯合航空公司有從達拉斯到舊金山	縮寫
顯示上月費城和丹佛之間的航班??十六	飛行
波士頓和丹佛I'd像飛行是需要停止的最少量的去波士頓之間	飛行
什麼是從印第安納波利斯飛往孟菲斯國際的價格	飛行
是否有比任何其他航空公司更多的航班通告航空公司	機票
從匹茲堡飛往紐瓦克的航班什麼週一	航空公司
直飛航班丹佛波士頓	飛行
顯示我的所有航班從密爾沃基到奧蘭多的一種方式	飛行
我需要從匹茲堡週四飛往巴爾的摩9點之前在巴爾的摩抵達	飛行
告訴我從達拉斯飛往舊金山的所有航班	飛行
你能告訴我一個辦法經濟艙票價從達拉斯到亞特蘭大	飛行
什麼類型的餐點都可以	機票
I'd喜歡的書從聖地亞哥到多倫多航班	膳食
最低票價從納什維爾飛往西雅圖	飛行
請列出從ST早上航班。路易聖。保羅	機票
顯示從丹佛飛往舊金山的所有航班	飛行
什麼是從華盛頓到舊金山的最低票價留下九月三十	飛行
列出從丹佛飛往華盛頓的直飛航班	機票
我想以後在週一六月十四4點鐘找到從明尼阿波利斯長灘航班，請	飛行
是的，我在尋找奧克蘭和波士頓之間的航班??，在達拉斯 - 沃斯堡停留你有其中的一個	飛行
什麼航班離開鳳凰週三晚上，在抵達密爾沃基	飛行
請告訴我從華盛頓到舊金山航班	飛行
哪個城市是MCO	飛行
什麼是從波士頓聯到舊金山的往返頭等艙票價	市
從聖何塞到達拉斯航班什麼星期五下午	機票
週五的紐瓦克和坦帕之間的航班	飛行
請給我往返票價從巴爾的摩到費城	飛行
告訴我從愛領域的航班	機票
發現從巴爾的摩的往返航班飛往匹茲堡的行程安排	飛行
哪些航班從有到孟菲斯拉斯維加斯	飛行
什麼航班從紐瓦克離開洛杉磯，下午	飛行
其中美國從波士頓飛往舊金山的航班進行連接	飛行
是的，我需要從丹佛飛往匹茲堡的航班上七月初七	飛行
機場名稱	飛行
我想在六月的早班飛機第一次從芝加哥到大陸航空公司西雅圖	飛機場
上午航班從舊金山抵達波士頓下午	飛行
請列出在匹茲堡提供地面運輸	飛行
I'd喜歡從丹佛飛往亞特蘭大在匹茲堡停止	飛行
找到從波士頓到奧克蘭最便宜的單程票價	飛行
從匹茲堡飛往舊金山的航班信息	機票
我想從費城離開，去亞特蘭大巴爾的摩和波士頓請列出航班	飛行
什麼是美國最早的航空公司的航班，我可以得到一流的從費城飛往達拉斯	飛行
從丹佛飛往威徹斯特縣紐約平日航班	飛行
哪些航班可以從波士頓到華盛頓晚星期一晚上或星期二清晨	飛行
是什麼限制AP57	飛行
什麼是從丹佛最早的航班到舊金山八月第二十七個上午	限制
地面交通請機場和市中心之間的城市波士頓	飛行
什麼從明尼阿波利斯飛往匹茲堡的航班	飛行
什麼類型的地面交通丹佛可用	飛行
讓我從達拉斯到無論是舊金山或奧克蘭的所有直航	飛行
告訴我從匹茲堡飛往舊金山週五航班	飛行
像我'd從明尼阿波利斯飛往晚，明天長的海灘	飛行
什麼航空公司從波士頓飛往亞特蘭大	飛行
請給我上月17歲的航班從費城到波士頓儘早信息	航空公司
什麼航班都可以週六從達拉斯舊金山	飛行
我需要下午6點後，週三鹽湖城航班從奧克蘭	飛行
我想從波士頓前往奧克蘭的團結，並在838班機，我應該走哪離開	飛行
I'd喜歡的書從丹佛飛往匹茲堡最廉價的單程航班	飛行
什麼是從波士頓機場波士頓的距離	飛行
什麼航班起飛和降落在米切爾將軍國際	距離
是什麼從波士頓到舊金山航班	飛行
是什麼在12月份從亞特蘭大到丹佛其停在波士頓的航班	飛行
哪些航班可以從匹茲堡飛往巴爾的摩七月二十五分之一1991	飛行
有沒有從波士頓到舊金山的航班使得在達拉斯 - 沃斯堡停留	飛行
多遠是奧克蘭離市區機場	飛行
告訴我，在多倫多到達從辛辛那提首飛	距離
從紐瓦克飛往坦帕的美國航空航班上週五	飛行
沒關係，你能告訴我通過美國航空公司的航班什麼葉達拉斯飛往舊金山	飛行
從費城飛往達拉斯亞特蘭大請停止航班列表	飛行
告訴我從巴爾的摩到達拉斯的航班	飛行
什麼才是最早的航班離開丹佛匹茲堡	飛行
什麼點航班從費城到匹茲堡	飛行
我想從華盛頓飛回達拉斯美航	飛行
I'd喜歡從亞特蘭大直飛巴爾的摩和晚上7點到達那裡	飛行
什麼航班從堪薩斯城到丹佛後，845在上午	飛行
讓我看看波士頓和舊金山之間的航空公司	飛行
什麼是最新的航班離開丹佛到達匹茲堡下星期一	航空公司
該公司波士頓和奧克蘭之間飛	飛行
什麼航班你有奧克蘭和波士頓之間，在達拉斯 - 沃斯堡停留	航空公司
我想在清晨離開	飛行
告訴我從丹佛飛往亞特蘭大的航班於六月十六	飛行
讓我從達拉斯到舊金山轉機，在1940年離開達拉斯 - 沃斯堡行程	飛行
我想奧克蘭和波士頓之間的航班??下午5點之前到達	飛行
告訴我從紐約飛往邁阿密的航班	飛行
告訴我在週四飛往華盛頓的航班丹佛	飛行
什麼航班從亞特蘭大到波士頓留下六月第二十九下午	飛行
告訴我飛機的類型，加拿大的航空公司使用	飛行
什麼是從費城飛往達拉斯早晨航班去美國航空公司	飛機
什麼呢MCO立場	飛行
我想知道在離開費城的航班，下午抵達匹茲堡的一些信息	縮寫
美國巴爾的摩3724費城什麼是往返票價	飛行
有4點的航班從華盛頓飛往丹佛	機票
從列出的匹茲堡第三次月在巴爾的摩到達的航班	飛行
告訴我從鳳凰城到密爾沃基週三所有航班	飛行
我想在週四下午6點前抵達亞特蘭大從巴爾的摩到亞特蘭大的航班信息	飛行
請列出從休斯敦到密爾沃基晚上週五航班上美國航空公司	飛行
我謹飛從匹茲堡飛往亞特蘭大	飛行
讓我知道從丹佛飛往拉斯維加斯的航班	飛行
什麼航班從丹佛飛往鹽湖城	飛行
我需要從芝加哥到密爾沃基傍晚航班列表	飛行
I'd喜歡尋找從華盛頓特區到亞特蘭大最便宜的航班	飛行
請列出的美國聯合航空公司的所有航班從丹佛中午前	飛行
在丹佛什麼樣的地面交通的有從機場到市區	飛行
什麼航班有週二早上從達拉斯到亞特蘭大	機票
讓我從亞特蘭大到費城三角洲飛行296車費	飛行
列出從亞特蘭大到費城週三最早的三航班	機票
從蒙特利爾到拉斯維加斯	飛行
你可以列出從華盛頓飛往多倫多最低的單程票價	飛行
是什麼從費城到舊金山的往返航班	飛行
告訴我從亞特蘭大到丹佛大家航航班為後天之本	飛行
顯示從匹茲堡飛往奧克蘭通過連接丹佛對我們的空中航班	飛行
一個上午週四10點之前的從波士頓到巴爾的摩所有航班列表	飛行
什麼機場在紐約最接近市中心	飛行
什麼航班有從坦帕到夏洛特	飛機場
什麼是從波士頓到費城最早的航班	飛行
告訴我從丹佛飛往舊金山的所有航班	飛行
從長灘到鳳凰的所有航班	飛行
什麼是FF	飛行
I'd喜歡從亞特蘭大到巴爾的摩直飛航班，在晚上7點左右獲得	縮寫
從費城到奧克蘭航班晚上	飛行
什麼呢AP57平均	飛行
請列出從加州奧克蘭到費城週二任何航班	縮寫
顯示從舊金山飛往丹佛的航班上週三和週四	飛行
你能告訴我從波士頓到舊金山最便宜的單程票價	飛行
什麼地面交通丹佛可用	機票
哪些航班可以從費城到丹佛，週日	飛行
從費城飛往達拉斯列表飛行，那停在亞特蘭大	飛行
丹佛和舊金山之間提供服務的航空公司名單	飛行
什麼才是從印第安納波利斯奧蘭多往返於12月25日第七最低票價	航空公司
什麼是最低的單程票價從匹茲堡飛往亞特蘭大	機票
什麼航班從紐約到洛杉磯	機票
什麼是票價代碼F	飛行
從丹佛飛往西雅圖的航班大陸上週六上午	縮寫
什麼是從匹茲堡最便宜的航班亞特蘭大留下十月初五	飛行
給我丹佛和波士頓之間的大陸航班列表	飛行
列出從奧克蘭每天飛往波士頓的航班使用大陸航空	飛行
什麼從塔科馬到奧蘭多航班星期六	飛行
什麼是從匹茲堡飛往亞特蘭大的航班的經濟艙票價	飛行
是什麼限制ap80的意義	機票
我今天需要從洛杉磯到夏洛特的航班	縮寫
告訴我所有類型的飛機	飛行
是什麼限制ap80	飛機
告訴我從亞特蘭大飛往舊金山其中下午5時後離開後天的所有航班	限制
我需要從紐約至多倫多週四飛行可能六經中午抵達	飛行
什麼是我的航班的選擇早退下午從明尼阿波利斯印第安納波利斯	飛行
現在我需要的航班信息離開亞特蘭大，並在下午抵達巴爾的摩	飛行
請列出所有從巴爾的摩到亞特蘭大的航班	飛行
是什麼匹茲堡和達拉斯之間的所有可用航班	飛行
從丹佛飛往匹茲堡四月二十一，我需要最便宜的航班	飛行
找到航班離開達拉斯，並打算到舊金山下午5點以後離開	飛行
從紐約飛往邁阿密的航班	飛行
清單航班從費城飛往達拉斯	飛行
我需要從匹茲堡到洛杉磯週四晚上航班	飛行
什麼是從丹佛飛往匹茲堡最廉價的航班準點起飛九月第二十八	飛行
什麼航班有從休斯敦到達拉斯	飛行
什麼呢地面交通的樣子在奧克蘭	飛行
告訴我從丹佛飛往拉斯維加斯的航班	飛行
哪些航班可以從丹佛飛往達拉斯沃思堡在下午	飛行
我需要從紐約到明天蒙特利爾的航班	飛行
告訴我航空公司在亞特蘭大的名字	飛行
I'd喜歡從舊金山飛到波士頓，在達拉斯 - 沃斯堡停留，我想在達美航空飛	航空公司
我需要找到從波士頓飛機到舊金山週五	飛行
告訴我從丹佛飛往舊金山的航班列表九月第1991	飛機
我需要在7月1日的堪薩斯城紐瓦克航班	飛行
什麼飛機擁有最大座位數	飛行
什麼是EWR	飛機
什麼地面交通可在巴爾的摩	縮寫
告訴我從丹佛飛往巴爾的摩的往返航班，提供在美國一流的服務	飛行
告訴我從達拉斯到舊金山下午4點後的特價單程航班離開達拉斯	飛行
什麼是一流的票價從達拉斯到巴爾的摩	飛行
告訴我從芝加哥到西雅圖在週六上午的大陸航班	機票
什麼美國西北航空公司航班在中午前離開丹佛	飛行
是否有下週一早上從匹茲堡飛往舊金山的航班的任何	飛行
哪些呢票價代碼QO平均	飛行
給我提供給匹茲堡週二航班從舊金山，也是價格	縮寫
雄鹿和魔術的一種方式之間的航班	飛行
什麼呢EWR平均	飛行
從巴爾的摩飛往舊金山的航班	縮寫
給我美航從明天ST最早的航班。聖彼得堡密爾沃基	飛行
沒有增量達拉斯和丹佛之間有什麼航班	飛行
我想從波士頓飛往巴爾的摩下午哪些航班有	飛行
在哪裡呢飛行UA 281從波士頓到奧克蘭站	飛行
我想訂一張從夏洛特飛往巴爾的摩四月十八	飛行
我想從肯尼迪到拉斯維加斯直飛航班三月第二	飛行
謝謝你的信息我現在想訂一張從費城到波士頓的班機於四月十六晚上9點左右	飛行
什麼飛行你從舊金山不得不匹茲堡八月第二十七個晚上	飛行
請給我的所有達拉斯和巴爾的摩和他們的成本之間的航班??列表	飛行
告訴我從達拉斯到休斯敦直飛航班	航班機票+
告訴我從波士頓到匹茲堡在週三和週四的航班	飛行
告訴我到達愛領域的航班	飛行
告訴我是出於愛場的航班	飛行
什麼是從波士頓到亞特蘭大的單程航班票價	飛行
我想離開費城和亞特蘭大在星期四抵達	機票
有來自巴爾的摩的往返航班達拉斯丹佛連接	飛行
什麼是從波士頓到亞特蘭大最早的航班	飛行
給我從芝加哥到西雅圖在週六上午的航班	飛行
休斯敦機場	飛行
我想從密爾沃基上午飛往科羅拉多州丹佛請	飛機場
你能告訴我從亞特蘭大飛往丹佛的飛機所使用的類型，對東方飛行825 555離開	飛行
是否有下週一早上從匹茲堡飛往舊金山的航班的任何	飛機
什麼航班從紐約到洛杉磯上午10點後	飛行
告訴我從華盛頓到奧克蘭的機票	飛行
什麼才是從匹茲堡最廉價的頭等艙機票舊金山	機票
什麼是票價代碼H	機票
告訴我週六和週日的密爾沃基飛往美國航空公司鳳凰	縮寫
多少的費用是從波士頓飛到一種方式來華盛頓一流	飛行
可我從紐瓦克飛往奧蘭多的航班，請	機票
什麼是從丹佛到奧克蘭最便宜的航班	飛行
告訴我，當天下午離開費城和丹佛之間的航班??列表	飛行
什麼是從長灘到孟菲斯最便宜的航班	飛行
告訴我從丹佛飛往匹茲堡該開飯所有航班	飛行
列出從聖何塞到休斯頓最短飛行	飛行
告訴我從丹佛飛往波士頓週二航班	飛行
我想從巴爾的摩前往華盛頓在星期一	飛行
給我留下的票價在星期二從丹佛去達拉斯	飛行
什麼是往返票一流的橡木和ATL之間的成本	機票
讓我從拉斯維加斯往返票價休斯敦馬不停蹄	機票
告訴我，從亞特蘭大到費城的航班	機票
哪些航班可以從丹佛到費城與匹茲堡停留	飛行
什麼是票價代碼QW平均	飛行
告訴我有關達拉斯沃斯堡機場和達拉斯市中心之間的地面交通	縮寫
列出從波士頓到丹佛的所有直航	飛行
是什麼從波士頓到舊金山航班	飛行
我需要從波士頓飛往丹佛的航班信息	飛行
什麼是從丹佛飛往匹茲堡最便宜的航班上月第二十六	飛行
什麼達拉斯和巴爾的摩之間的教練的航班將在八月十和返回八月12	飛行
好吧我想知道的是的確從夏洛特到拉斯維加斯與ST停止TWA航班505。路易擔任晚宴的TWA航班505或163	飛行
還好的是一個莫大過於現在我們打算去四月第二十二達拉斯華盛頓的最新夜間出發單程	飛行
什麼才是從舊金山到波士頓最早的航班	飛行
顯示從舊金山公務艙票價丹佛聯合航空公司	飛行
告訴我從坦帕到ST航班。路易	機票
從波士頓去什麼飛往亞特蘭大下週二	飛行
請列出從ST離開的航班。路易聖。保羅上午10點後	飛行
顯示九月十五舊金山和費城之間的所有航班	飛行
我需要從舊金山到波士頓的班機是晚上8點以後葉	飛行
告訴我從蒙特利爾飛往芝加哥的航班	飛行
什麼航班你從安大略省有	飛行
什麼克利夫蘭S中的最便宜的頭等艙往返機票的價格對我們的空氣邁阿密	飛行
有沒有從匹茲堡飛往巴爾的摩任何渦輪螺旋槳飛機航班十二月十七	機票
顯示從匹茲堡到奧克蘭航班	飛行
告訴我從巴爾的摩到奧克蘭的航班晚餐	飛行
請找到從波士頓到丹佛盡可能早的航班	飛行
告訴我從愛場航班的任何其他機場	飛行
我可以從長灘機場打車到市區長灘	飛行
多久是從亞特蘭大飛往舊金山中午十一月十七	飛行
是什麼從巴爾的摩到達拉斯在週日下午的航班	距離
讓我從舊金山到奧克蘭的所有航班	飛行
什麼地面交通可從匹茲堡機場	飛行
什麼是一流的票價從印第安納波利斯飛往奧蘭多	航空公司
現在向我展示從匹茲堡到巴爾的摩的航班	機票
告訴我所有的美國西北航空公司從紐約到密爾沃基飛往洛杉磯	飛行
什麼是具有從華盛頓到舊金山上週五沒有停止最早的航班	飛行
告訴我頭等艙機票從達拉斯到巴爾的摩	飛行
從丹佛飛往費城大陸	機票
請再告訴我頭等艙機票從巴爾的摩到達拉斯	飛行
告訴我從底特律到芝加哥所有中西部快捷航班	機票
從亞特蘭大到波士頓航班列表下午6點至下午10留在8月8號	飛行
從費城到丹佛下午航班信息	飛行
偉大的現在我想找出什麼是在四月二十從華盛頓飛往丹佛你有一個航班最便宜的票價圍在早上5點	飛行
我需要從丹佛飛往費城的航班上週六	飛行
讓我從威徹斯特縣到辛辛那提的航班	飛行
哪些航班可以從丹佛到費城週一	飛行
什麼是從紐瓦克的航班票價教練到下午3點以後離開洛杉磯	飛行
什麼三角洲航班從華盛頓飛往達拉斯早晨	機票
I'd喜歡做亞特蘭大和波士頓之間的旅行中，我想知道的最便宜的票價	飛行
給我從波士頓到亞特蘭大首飛	飛行
沒有美國航空公司從波士頓飛往舊金山	飛行
從達拉斯到坦帕航班什麼	飛行
謝謝你，我還需要行駛下週三晚上從達拉斯到舊金山	飛行
告訴我在華盛頓特區機場	飛行
什麼是從達拉斯到丹佛往返的最低票價	飛機場
還好和可能四個I想從亞特蘭大到去丹佛清晨離開8點左右	機票
列出從舊金山到費城的美國航空公司航班	飛行
哪些呢票價代碼QO平均	飛行
你有沒有從丹佛的819航班飛往舊金山	縮寫
什麼是最早的美國聯合航空公司航班從丹佛飛往巴爾的摩和抵達七月四日	飛行
我想預定在四月第六從坦帕清晨飛往夏洛特	飛行
上午航班從奧克蘭飛往達拉斯	飛行
告訴我從紐約飛往邁阿密的航班	飛行
列出的航班和離開時間離開達拉斯 - 沃斯堡為波士頓的航班下午6時後	飛行
從匹茲堡飛往洛杉磯的航班列表離開這週四下午5點以後	飛行
I'd喜歡從巴爾的摩到波士頓的班機在清晨，因為我可以	飛行
告訴我，從奧克蘭到費城週六這之前中午開飯，並到達費城的所有航班	飛行
我想預訂從芝加哥飛往西雅圖六月第一	飛行
告訴我經濟艙票價從達拉斯到巴爾的摩	飛行
請列出價格在匹茲堡汽車租賃	機票
從紐瓦克到克利夫蘭每天出港航班下午五點	飛行
告訴我從波士頓到奧克蘭航班	飛行
讓我從ST的航班。聖彼得堡是多倫多週一休假	飛行
請列出波士頓和亞特蘭大之間的所有航班	飛行
有達美航空公司航班從波士頓到丹佛	飛行
給我上月第二十七個從奧蘭多飛往印第安納波利斯的機票的航班和票價	飛行
給我從紐約到拉斯維加斯是在星期日抵達所有直達航班	航班機票+
什麼航班離開波士頓和費城早上7點之前到達	飛行
I'd喜歡從波士頓到舊金山起飛的航班在下午的任何時間，請	飛行
從辛辛那提到達拉斯航班417	飛行
從休斯敦到孟菲斯六月第二十九列表航班	飛行
從達拉斯到舊金山的航班列表	飛行
請重複星期一八月十九飛行班次從丹佛飛往匹茲堡	飛行
在哪裡呢陸飛芝加哥	飛行
什麼地面交通可從丹佛機場丹佛市中心	飛行
有沒有在TWA航班從巴爾的摩到舊金山，丹佛停止	飛行
鳳凰紐瓦克週三	飛行
紐瓦克到克利夫蘭	飛行
什麼航班從鳳凰城離開	飛行
航班信息從匹茲堡飛往丹佛	飛行
告訴我從丹佛飛往費城國際	飛行
給我看在丹佛地面交通	飛行
沒關係，你能告訴我要離開達拉斯到費城你會從達拉斯出發到費城的最新航班飛行	航空公司
告訴我從波士頓到丹佛八月第二個航班	飛行
告訴我關於聯合國從波士頓留下的所有航班	飛行
你能告訴我的第一次飛行離開巴爾的摩到舊金山747八月第二十七	飛行
請給我從亞特蘭大到波士頓在週三下午和週四上午航班	飛行
顯示所有離開星期一早上從波士頓飛往匹茲堡的航班	飛行
讓我從舊金山到波士頓的航班增量	飛行
告訴我從巴爾的摩到奧克蘭航班	飛行
什麼類型的飛機都是從克利夫蘭到達拉斯的航班使用的中午前離開	飛行
非常好我正在對方案三我感興趣的一個航班上的727從華盛頓到喬治亞州亞特蘭大	飛機
從直流飛往鹽湖城	飛行
I'd喜歡做從華盛頓到舊金山之旅	飛行
是否有服務波士頓DC和達拉斯航空公司	飛行
航空公司是表示dl	航空公司
我想看到從丹佛飛往費城的航班	航空公司
告訴我從匹茲堡到達拉斯的最便宜的單程票價中午至下午2點離開匹茲堡	飛行
顯示出與第一類從巴爾的摩到達拉斯的所有航班	飛行
I'd喜歡從達拉斯到波士頓最早的航班	飛行
什麼是從匹茲堡飛往丹佛的航班教練票價	飛行
我可以把波士頓和亞特蘭大之間的航班??是什麼這樣，當我離開波士頓，我將在亞特蘭大地面的最長時間，並在同一天仍然會返回	機票
告訴我從費城到佐治亞州亞特蘭大的航班	飛行
我們打算從丹佛飛往舊金山	飛行
什麼航空公司有從巴爾的摩飛往西雅圖的航班	飛行
讓我知道從密爾沃基飛往奧蘭多的航班中午之後星期三啟程和星期四中午前	航空公司
去匹茲堡什麼航空公司	飛行
I'd喜歡從費城飛往舊金山，在達拉斯停留	航空公司
什麼是城市沃斯堡的可用的地面交通	飛行
告訴我從休斯敦到拉斯維加斯直飛往返	飛行
請列出從舊金山到匹茲堡在週日的所有航班	飛行
我想從費城飛往達拉斯飛行在亞特蘭大停止	飛行
什麼是從丹佛飛往匹茲堡三角洲航空公司的航班機票費用	飛行
你有沒有從丹佛飛往巴爾的摩通過達拉斯的任何航班	機票
該航空公司飛入和出的丹佛	飛行
的確，從波士頓到舊金山飛大陸在丹佛停止	航空公司
有來自丹佛的增量飛往舊金山	飛行
